TCGAGCAGTTCGTTCTCAAGAGCCGCTACAC	Mycobacterium alsense
GCTGCCCGCCTACACGGCCGCGAAGTCGATG	Mycobacterium alsense
GTCGAGCACGTGGCCGGTCGTCGTGCCGTGC	Mycobacterium alsense
GGGCGCGGGCAGCTTCCTGACCGCCGACCCG	Mycobacterium alsense
GCCGTGGTCGGAGTGGTACGCCGGGCGCCCG	Mycobacterium alsense
GCGGCGCGGGCGGCGGCCGCGCGGGACCGGG	Mycobacterium alsense
GCGCGCGATCGCCGGCGCGGCCGCCGAGGGG	Mycobacterium alsense
AGGCTGGTCAACCCGCACGCCTATGAGCCCG	Mycobacterium alsense
AGTCCCGACCTGCCGATTTCGGCCACCGCGG	Mycobacterium alsense
AATTGGTCGATTCCCTGCGCTCGGGCGAGCC	Mycobacterium alsense
TGGTGGCCCTGGGCTGAGGGTGATCGGCCGC	Mycobacterium alsense
AGGGAACGGGGTATGTCCACCAACGTCACGC	Mycobacterium alsense
ATCCAGGCCCGTGTCAACATGGAGACCTTGG	Mycobacterium alsense
TCAGGCATGACGGTTCACTCCCATGGGATGC	Mycobacterium alsense
TTCCGGCGCAACGCCCTGGTCGCCGCGCTGG	Mycobacterium alsense
CGAGGCCACCGCCGGCCGCATGTGCCACAAG	Mycobacterium alsense
GCGCCCTGGCGAAGCTGTTCACCCCCGAGCA	Mycobacterium alsense
CCACATGGCCGTCCTGCCGAACAGCGAGCCC	Mycobacterium alsense
CAGGCGTGCCTTCGCCGCGTCCGCGGCGGCC	Mycobacterium alsense
TCCCCGGCGATCTCCGAGAAGGCCCTGGTTT	Mycobacterium alsense
CACGCGTAGCTGTACGTCGGCACAAAAACCT	Mycobacterium asiaticum
CTGCCCGGCGTCGGAAAAATCCAGCAATACG	Mycobacterium asiaticum
TAGCCCCGTGTTGGTGTCTGACCCCCCGACC	Mycobacterium asiaticum
TCGGGGTCGAGCCCAACCACTTTGAGTTCCC	Mycobacterium asiaticum
GTACTCGAGTACGTCTGGGGCCGTCAAGTAG	Mycobacterium asiaticum
CGCGCACGCCTGCAGCGCCTCGCCGACCTTA	Mycobacterium asiaticum
GCTGAACTGCGAGATCGTGGACTGGTGCCGG	Mycobacterium asiaticum
CTACTATGCCGCCATGGCGCTCGACGAAGGT	Mycobacterium asiaticum
GCCCACGTGGTGATCGTGGTCGAGGAGAACC	Mycobacterium asiaticum
AAGCCGAGATGGTGGTGGAGCGCAAGGCCGT	Mycobacterium asiaticum
CCGATTTCCTGCAACTGGGACTGGACAGCAT	Mycobacterium attenuatum
TCGAGGCGCACATCGTAGCGTGCGGTCAGCA	Mycobacterium attenuatum
GGGCTGGGCATCGAAGAATCGGTGATCGAGT	Mycobacterium attenuatum
GTGGGTCGCATCGCCGAATCCGTGGCCAACC	Mycobacterium attenuatum
TCGCGGGCACGAACGGCCTGTCGCCACCGAT	Mycobacterium attenuatum
GATCCGCGGCGTGTCTACGAATATCCCCTTC	Mycobacterium attenuatum
CGGCGTTGAGCGCGGCGAACGCTGCGGCGGC	Mycobacterium attenuatum
CGCGGTAGCGCCGAAACCGTGCGTGAGCAAA	Mycobacterium attenuatum
TCACAGCCGCGTGACATCACCGATCGTGCAG	Mycobacterium attenuatum
GGCTAACAGCCCCGAATCGGTGGGATAGGCG	Mycobacterium attenuatum
CAGCCGCCGCCGTCCCACCGCCCCCGCCGCC	Mycobacterium avium
GCCGCCGCCGTCCCACCGCCCCCGCCGCCAC	Mycobacterium avium
CCAGCCGCCGCCGTCCCACCGCCCCCGCCGC	Mycobacterium avium
CGTGGCCCCGGTCGGGGCGGGGGAGGCGGAG	Mycobacterium avium
AGCCGCCGCCGTCCCACCGCCCCCGCCGCCA	Mycobacterium avium
CCCCAGCCGCCGCCGTCCCACCGCCCCCGCC	Mycobacterium avium
CGCCGCCGTCCCACCGCCCCCGCCGCCACCC	Mycobacterium avium
CCGCCGCCGTCCCACCGCCCCCGCCGCCACC	Mycobacterium avium
GTGGCCCCGGTCGGGGCGGGGGAGGCGGAGG	Mycobacterium avium
CCGACCCCAGCCGCCGCCGTCCCACCGCCCC	Mycobacterium avium
AAATCGCGGCGGTCGTAGTCGGGCCACAACT	Mycobacterium avium subsp. avium
CGTATTCCTGGCAGGCGGCCCACAAATCGCG	Mycobacterium avium subsp. avium
GGCCGAACCGCCTTTGGCGGCTCACGCTCAG	Mycobacterium avium subsp. avium
CGCGTACGGGATCAGCGTGTTGATGCCGTCG	Mycobacterium avium subsp. avium
CCCAACGGTTGGCTGGCGGCCAGCTTGGGGG	Mycobacterium avium subsp. avium
GTCGACCCCAGTTATTGCCAACCGGCGCCGT	Mycobacterium avium subsp. avium
CAGGATGCCGGCGTCGATCAGCTTGGTCCAC	Mycobacterium avium subsp. avium
AGGCCGATGCGCCGGCCCGGGCGCGGCGCGG	Mycobacterium avium subsp. avium
ACTCGGCCGCCAGGTCGCGGGCCTTGGGACT	Mycobacterium avium subsp. avium
CTCCTCGCCGGCTACCAGCACGTGCTGTGCG	Mycobacterium avium subsp. avium
ACCATCCTGGCAACTGGACCGTCGGCGGGAT	Mycobacterium avium subsp. paratuberculosis
GGTCGGCACCGCGGCGGCGTCCCGAAGCGGA	Mycobacterium avium subsp. paratuberculosis
AGCCGCGCAAGATCGTCTATCCCGGATCGCG	Mycobacterium avium subsp. paratuberculosis
TCTCCGAGCCATTGGGGGCGACCCGGTATTT	Mycobacterium avium subsp. paratuberculosis
GTTTATCGCGGCAGGTCAGCGCCGGGACCGC	Mycobacterium avium subsp. paratuberculosis
AAGCGGACGGCAGCTGGACGAGGCGCGTATC	Mycobacterium avium subsp. paratuberculosis
GATCGCGGTCACTTGCGGTCCGGTGAGGCTG	Mycobacterium avium subsp. paratuberculosis
CCGGGTAGCCGCCCTGACCGACTCGCTGCAC	Mycobacterium avium subsp. paratuberculosis
GGGGCGCGCCGCGGCGCACCGCGGTGACGGC	Mycobacterium avium subsp. paratuberculosis
ACGGAGACGACGTCGGCGGACTCGAACAGGG	Mycobacterium avium subsp. paratuberculosis
GAGCGGAGGTCAAGCGTCAGACCGGAGCGGA	Mycobacterium bohemicum
CTGTGCTCCAACATCATTCGCGACCGCGCGA	Mycobacterium bohemicum
GGAACCGCCCGCCCGGGTGTAGGCCATCACC	Mycobacterium bohemicum
TCCAGGGTCAGCCTTTCCTCGGGACCCAGCA	Mycobacterium bohemicum
CCCGCTTCCGGCGGTCGGCCAGATAGCCGGT	Mycobacterium bohemicum
GTCCCACCCGGCGGCGCGGTTGCAGGAACCG	Mycobacterium bohemicum
CGCCGCGATCCCATCGCGCCGACATAGCCGA	Mycobacterium bohemicum
TTCGACTTCGACGTCCTCGGCCGCGCAGCGA	Mycobacterium bohemicum
GGTCGACGAAATTCGCTCTGGCGTAAGGAGA	Mycobacterium bohemicum
AGAGGCCGCGCGCATGACCGACGTGATCGTC	Mycobacterium bohemicum
CGGCTCGCCGGCGTTGACGATCACCACGTCG	Mycobacterium branderi
GGACGGCGCAGAAGATCTCCGGAGCATAGGT	Mycobacterium branderi
GAATTAGCCACCCGCGCAATGGATCCCGACG	Mycobacterium branderi
TGAAACCGGTGCGCGCCACCATCGCGACCAC	Mycobacterium branderi
GGTCGGGGATCGGCTGCACCCGGTGCTCAAC	Mycobacterium branderi
CGAGGGAGTCAAAGCCGCCAGCGTGATCATG	Mycobacterium branderi
GGTCACCCGTCGACCCGCGAGATTCGAGTTC	Mycobacterium branderi
GCCGTCGATTGCGGCTGTGCACGGCGTGGCA	Mycobacterium branderi
CTTTAGGTGCGCATTTCACCACTGCTGCACC	Mycobacterium branderi
GACGGGCACATCGGCGAGAAGCTGAATCGCA	Mycobacterium branderi
TCTGGTCGATGACCCCTGCAGTTGCTTCGGT	Mycobacterium canettii
ATCTGCAGATCGGCGAGCCGCCCGTGTCTGG	Mycobacterium canettii
GGTGGACTTCTCCCGCGACAGCTCGGCGCGG	Mycobacterium canettii
TCGACGGCACCATCCGTTCCCAGCGCTCAAC	Mycobacterium canettii
GCCCGCCGCCACCAGCTCCGCGATGTCGTTC	Mycobacterium canettii
GTACACCACCAGCTGCGCATTCGACGTGTAG	Mycobacterium canettii
CTGACAGGCCGCTCCGTTCGACCGTGCCGAC	Mycobacterium canettii
GGAGCCGTGGCTTCGTCAAAAGGTCAGGCGC	Mycobacterium canettii
ACATGAATGGCTTGATCTCACAAGCGCGCGG	Mycobacterium canettii
ATCTTGACAAGCCGTTCGCCATCGAGGCGTC	Mycobacterium canettii
GCGGGAGTTGGGGTGGCGCCTGGAGGTCGAT	Mycobacterium celatum
GCGGCCACAGGCAATTCACCGCGATCCCGTC	Mycobacterium celatum
CGGCACGATGCGCGTCGGCCACCTTGTGCGC	Mycobacterium celatum
CGTTCCCGACCGCTCAGCTGCCCCGGCTGCG	Mycobacterium celatum
CTGGTGGCGCCGGTAATCGGTGCACTGGCCG	Mycobacterium celatum
GGGTGATTCCGTTTTCTCACCGGGAGTCACC	Mycobacterium celatum
CAAACGGCTCGGCCTGCCGGTGGCCGCCAAT	Mycobacterium celatum
ATGTCCCATAAGTCGTCGGGGCTTTGGACTC	Mycobacterium celatum
GCCCTGGAAGCCGGCGTGCGCGAACTGCGGA	Mycobacterium celatum
CGACGACGGCATCCCGGTATGCACGGCCTCG	Mycobacterium celatum
CGCGTCTTCTCCTTCGCCCGCGACGAAGAGA	Mycobacterium colombiense
GGCATCCGCGCCTGCAGAGACTCGAGCAGGT	Mycobacterium colombiense
GATCAGCAGCACGTCGTGCCGCCGGCAGATG	Mycobacterium colombiense
ATCGCGCCGCTGGCGTTTTGCACCTGCCCGC	Mycobacterium colombiense
GAGATCCGGGCAACGCTGGCCACACTAGGCC	Mycobacterium colombiense
GCCGGTACGCCGCGCAGACCTCCGACATCTC	Mycobacterium colombiense
ATGGCCCGGGAGAACGCGAAACCCGTGATCG	Mycobacterium colombiense
GCGTCACCTTCGACCACCCCTCGGCGGCGAA	Mycobacterium colombiense
GTACAGCACGCGGGCGTCCTCGGCGACGCAG	Mycobacterium colombiense
AGCGTGCCCGACGCGTTGTGGCCCGCCGTCG	Mycobacterium colombiense
AGGCTGCACCACCTGTTCGCCCGGATGCCCG	Mycobacterium conspicuum
GTCTGTGGGGCGTGCGCCGCAGTTTGCGCCG	Mycobacterium conspicuum
GCCCATCATGGCGCCGCACAACCCCATCAGC	Mycobacterium conspicuum
CCTCCATCCGGCGCGGGGTGAAAACCCTTGA	Mycobacterium conspicuum
GATGTCGGGTCCGCTGAGCTTGATGGCCTCG	Mycobacterium conspicuum
GCCGTTGTCGAGCACCGCGATCACCGAGACG	Mycobacterium conspicuum
ATTGCCCAGCGCTGGGGTAGCCGAAATCCAA	Mycobacterium conspicuum
GCGACTTGACTTTCGGTGACAGTGCACTGAT	Mycobacterium conspicuum
CGCGTCGGCGACGTCGACCAATACCGCGGCG	Mycobacterium conspicuum
GTACGCCTCCCGCAGCGCGCTGATTACCTTG	Mycobacterium conspicuum
CGGACGGTGTCCGACGTGCAGGCCATCACCA	Mycobacterium doricum
TACGAGAGTTTCAGCCGCCCCGAGATCATCA	Mycobacterium doricum
GTGGCACCTGCGTCGCCGCTCTTCTCCGGGT	Mycobacterium doricum
GGCCTGTCCAGCCGGGTCGGCGCGGACCTGG	Mycobacterium doricum
CGCTGCCGTACGGCCTCGACCCCGCCCGGGT	Mycobacterium doricum
TCGCCTCGGTCATCTTCGTTTCGATGAACCC	Mycobacterium doricum
AAGCATGACGGTATCCCGGACACCGAGTCCG	Mycobacterium doricum
GTACCGGACGGGACAGCATGAAGCCCTGGGC	Mycobacterium doricum
GGTGGCCACCAGCGACGGTGAGCTGGCTGAC	Mycobacterium doricum
ATGTCGGGCCACTTGTGGTCGGGCAGGGGCC	Mycobacterium doricum
ATGGCCGCACACGGCGACCTGATGGCCGAAG	Mycobacterium europaeum
GGCCCGGCGACGCCGACCAGCCCACCGTCTT	Mycobacterium europaeum
AATTCATCATCACCGGCTCGTTTCTGACCCT	Mycobacterium europaeum
CAGCGCCAGGCCCAGCAGCGCCAGCCCGGCG	Mycobacterium europaeum
ACGACGTCGGGGGCGCTTTCCAACGACGCGC	Mycobacterium europaeum
CAATGGCTCTCCGACGTCGGCGCCGACTCCG	Mycobacterium europaeum
CCGACTTCTCGCTCACCGGGCTGCAGGAACC	Mycobacterium europaeum
TTCAGTGTGCGCCGATGGCTTCGAGTGTGCG	Mycobacterium europaeum
CCCGTCGCCGCGAAGGCGTCCCGCGCCTTGG	Mycobacterium europaeum
GTGCGGCCACCGGCACGCTGACCGTGCGGGT	Mycobacterium europaeum
GCATGCCGTGGGACCCCCAGGACCATCTCGG	Mycobacterium florentinum
ATTCGGCCTGCAGGATGCCAATACGCTCGAG	Mycobacterium florentinum
TGCCACACGATCTGCTGGCTCGGGTCATCGA	Mycobacterium florentinum
CGCAGATGCAGTTCGGTGGCACCACCATCTG	Mycobacterium florentinum
CAGGCGCGGCGGTGCTGGACACCGCGGCCGC	Mycobacterium florentinum
GCAGTGTCGGGGCGGGCTTTCCGGCCACCTT	Mycobacterium florentinum
AGAAAGTCGCGATCACCACCGACGCCTGCCC	Mycobacterium florentinum
CACCCTGTTGCCCAGCTTGCGCATCAGCGTG	Mycobacterium florentinum
AGGGCGGGTTTTCGGCGGAATTTCCGCCACC	Mycobacterium florentinum
CAGCTTGAGCGCGGTCACCGTGGCGTGCACC	Mycobacterium florentinum
GCGGGTGCTCACCTGCATGCGGTGGCGCGAC	Mycobacterium gordonae
CGGCGGACAGCACGACGTCCTTGCGCGCGAC	Mycobacterium gordonae
ACGCCAACGAGATCTGGCATTTCGAGCTGGC	Mycobacterium gordonae
GCGGACCACCACTCGTTGAGCGATTGTTCGC	Mycobacterium gordonae
CGACGTCGAGCCCAACCGGATGGTGGCCGCG	Mycobacterium gordonae
ATCGGCGGGAATCGCCACCATTGGTATCGGC	Mycobacterium gordonae
ACGACAGCCTGATCTACGCCAGGATCCTGCG	Mycobacterium gordonae
AGGGCTGCCGGCGGACTCCCACAACTGGCCG	Mycobacterium gordonae
GCCGCGCTCGACCTCGATCCAGGCAACGGCA	Mycobacterium gordonae
CTCGGCCGCGGCTCGCCGTACCTGATCGGCG	Mycobacterium gordonae
GGCACGCCCCACACCGGCGTGGGCTTGGGCT	Mycobacterium grossiae
GCAGCGGAGGTTGTCGCTGTACTGACTGGCC	Mycobacterium grossiae
GTGGGCGGGTGATGGCAGTGGTCTCCGAGTT	Mycobacterium grossiae
GGGCGGGTCGTACTGCTGCAGCACGCCGCCG	Mycobacterium grossiae
GATGATGATGCCGGCGGAGTTCGGCGAATCC	Mycobacterium grossiae
CCGCCGCGACGGACAACCTCTTCGTCATCGG	Mycobacterium grossiae
GATGATCGCCTTGCGGCGCGTGCTCATTCCG	Mycobacterium grossiae
CACCCGGTGACCGCCACGGCGACTACGTCGT	Mycobacterium grossiae
TAGCGGATCCTCGCATTCGCCGCACCACGGT	Mycobacterium grossiae
TCCCGACGGGCACGGGCACGTCTACGTGCGC	Mycobacterium grossiae
GTGGTTTGCGACCTCTGCGCCAACGCGGGAG	Mycobacterium haemophilum
GGAAGCACAACATGTAAGCCATCGGATACGA	Mycobacterium haemophilum
TTAGCGTTATCACGAAGCGAGCGCTGAACAC	Mycobacterium haemophilum
TGCGGCGACCGGGATGCCCGGACTGCCCGGG	Mycobacterium haemophilum
GATGGCATAGATTCCGCCCGCCTTGACCCAG	Mycobacterium haemophilum
CGGAAGCTGATAAAGGGTAAACCGGTAGTGG	Mycobacterium haemophilum
GCGACCTCGATAGCTGTCCAGGCAGGCGTCG	Mycobacterium haemophilum
CCGATCTGGTGGTTGTCGGAATCGGGTCACG	Mycobacterium haemophilum
AAGCCGGAGATTTGTGCTGCGACATCACTAA	Mycobacterium haemophilum
CGATATTGTGGTGACCGACTTCGTCGAAATC	Mycobacterium haemophilum
CGAGTTGATGCGGTTGCGCGCACACACCATG	Mycobacterium heckeshornense
CCAATCAAAAACGCGACCCACAAGGACCCGT	Mycobacterium heckeshornense
TCCTTATGGATACCTTCACGAAAGCGTGGGC	Mycobacterium heckeshornense
CCCCGAACAGGCAAGACGCCCGGGTGCGACG	Mycobacterium heckeshornense
CGCATTCGACGTACTTGCCGACACAGTCGTG	Mycobacterium heckeshornense
CCATGCATCCCCTCGTCGAGCAGGTGCACCG	Mycobacterium heckeshornense
TCATGCTTGGACATTCGGAAGGCCTTCTCGA	Mycobacterium heckeshornense
TGACCCGCTCGTCCGACGTCCACGAGATCGC	Mycobacterium heckeshornense
CGCCGCGTCGCGCTCGATCCGGTCGATACGG	Mycobacterium heckeshornense
CAGCAGCACCAGGAAAAACGGTACCGCGAAG	Mycobacterium heckeshornense
TCGGTGGCACAACGCGTCGGCATCACGCCGT	Mycobacterium heidelbergense
TCGGTGCCGCCGGGCGGCGGCGGCGCGCTGC	Mycobacterium heidelbergense
TCCTTTGCACAATTCTGAATAACGACGAAAT	Mycobacterium heidelbergense
CGCGGATTGCGGCAGCATCAAGATCCTGGAG	Mycobacterium heidelbergense
GGCCTTGGTCGCGTCTCTGGTGATCGTCGGG	Mycobacterium heidelbergense
GACAGCGGCGCGTACTCGGCGACCGACTCGG	Mycobacterium heidelbergense
CGGTCCTGTTCTGCCGCAGGTGCTGGACCAG	Mycobacterium heidelbergense
GGCGGTCGTAGTTCTTGCCGTTGTCGTGCAG	Mycobacterium heidelbergense
CTCGGCCGGCGGCACCCGTTTCCTCGAGGTC	Mycobacterium heidelbergense
CGCCGGTTCCGGTGCCGGTATCGCCCGGCGG	Mycobacterium heidelbergense
CGTGCCACGCGTGCCAGGCCAGAAACGCCAC	Mycobacterium helveticum
CTTGGTGTCGAGGACCCGGTACCGCCCGCCG	Mycobacterium helveticum
TGAAATGAGCAACGACGTCGCGATCGTCGGC	Mycobacterium helveticum
TCAAGCTCCTGCTGGAGTTCGCCGACGACCT	Mycobacterium helveticum
CTCCGACGAGGACATCGCCCGCCCGGGCAGC	Mycobacterium helveticum
GGCGTGCTCTCGATGTGCGCGGGCGGCGGCA	Mycobacterium helveticum
GGTACGCGCGAGTCTTCCGTCGCCGAGACGT	Mycobacterium helveticum
ACTACCCCCACCTGCTGGCGTTGTCGGCGTC	Mycobacterium helveticum
AGAGCTACGGCGACGGCGCCAACGGCCCCAA	Mycobacterium helveticum
GCCACCGTTGGACCGGCCCGCCGCCGGGGGC	Mycobacterium helveticum
GCGTCGGGCATCCGGGCAAACAGATGATGCA	Mycobacterium intermedium
AAAGCCTTTGAGTGTCAACGGGCTCTGGACG	Mycobacterium intermedium
CCCACGTGTTGAACGGGTAGCCGTGGATGAG	Mycobacterium intermedium
TGAACATGACGAAAGTGACCGCCGCGTTGAC	Mycobacterium intermedium
CTCCGGCCGTTTTGCACGCCGATTCGAATCT	Mycobacterium intermedium
TTCTGGCCCGATAGGGACCGCGACGGGTGCA	Mycobacterium intermedium
TCGGCGATTGTGTCGGTCACGGGCTGGCCGC	Mycobacterium intermedium
CGAGCTGAAACCGAAGCGGCTCAACGTAATT	Mycobacterium intermedium
CGGGCAGGCGCCGATAGTCTTCATCTCGATG	Mycobacterium intermedium
TTCGCGTCGCGCGACGACAACACCCGCCCGC	Mycobacterium intermedium
TTTTTGTGCGTCCCTACGAAGCGGCCTAGAA	Mycobacterium intracellulare
GGCGAAAACACCCGCGCGCTGGTCATCGCCC	Mycobacterium intracellulare
CATTCCACGCGGCCGGCGGGTGCGGCCACGT	Mycobacterium intracellulare
CAGAGGCGCTGGGAGGCGGGAGAACACTATG	Mycobacterium intracellulare
CACCCGCCGAGGTGTTTCATGCGTCGCGTGG	Mycobacterium intracellulare
TTGGAGTGTCGGCTTTCCGGACCATCCGGAA	Mycobacterium intracellulare
CCCGGGATCGGAGTCGGTGACCACCAAGCTG	Mycobacterium intracellulare
CTGAGCTGTGCCCAGAGTCCCTTGCCCTGAT	Mycobacterium intracellulare
TCATTCCGACCGTCGAGGTAAGCGTCGAGAA	Mycobacterium intracellulare
GCGCCGCGGCCCCGGCGTTGTCGGTGCCCAA	Mycobacterium intracellulare
ACGAATTCGCCTACCGGCTGTCCGGATCCGC	Mycobacterium intracellulare subsp. chimaera
CCGCGCCGTGGAAGGCTTCCGCCAGACTCGA	Mycobacterium intracellulare subsp. chimaera
GGAGATCTCCGAAGGCCGGCCGTGATCGCAC	Mycobacterium intracellulare subsp. chimaera
CGAGCAGATCTCTCGCCCGGAGTATTCGGTT	Mycobacterium intracellulare subsp. chimaera
GCCCGGCGACGCCGGATCGTCTGCGCGACGG	Mycobacterium intracellulare subsp. chimaera
GAGTTCGTCGCCGGCGTAGACGCTCGGCACC	Mycobacterium intracellulare subsp. chimaera
GCCAGTCACAATCGACAACATATGTCGGACA	Mycobacterium intracellulare subsp. chimaera
TTCCCCTGGTTCAGGCGGCCGCGGCGGTCGC	Mycobacterium intracellulare subsp. chimaera
TGGGACCTGGCCGACGCATTCCCCGTCGCCC	Mycobacterium intracellulare subsp. chimaera
CTACGCCCCCGGCACGGCCGCCAAGCGGCTG	Mycobacterium intracellulare subsp. chimaera
CCCACCCGACGACCTGGTCGGGATGATCGGT	Mycobacterium intracellulare subsp. yongonense
CATCGCCGCGTCGTCGCCAACCGGCGATCCC	Mycobacterium intracellulare subsp. yongonense
ACCCCACGGCGCGATCAGCTGATCGGCGCGC	Mycobacterium intracellulare subsp. yongonense
GGCGCACATCGTCGCGCAGGCCGAGCCGCGC	Mycobacterium intracellulare subsp. yongonense
TCGCGGAGTGGTTCGAAATCGGCGACCTCCC	Mycobacterium intracellulare subsp. yongonense
ACGGCGATCGTCGACCGCTTCAGACCGTTCT	Mycobacterium intracellulare subsp. yongonense
GCTGCGTTCGTTTCGCTCACAGGCCTACCGC	Mycobacterium intracellulare subsp. yongonense
GGCTGACGAACGCGCCGACGTCGGTCGGGGT	Mycobacterium intracellulare subsp. yongonense
CACCGCGAGGTTTGCGCTGGAGTCGGCCGAC	Mycobacterium intracellulare subsp. yongonense
ATCGACCATCGCCTCGGAGCCGACGACCCCC	Mycobacterium intracellulare subsp. yongonense
ATCACCAGCAGGCCGATCAGCTGGATTACCG	Mycobacterium kansasii
ATGGACTCGTTCAGCGACGGGAGGAATCCGC	Mycobacterium kansasii
CCTTCCTGGCGCGGCGGGAAAGGTTGAAGAA	Mycobacterium kansasii
CGGTGGCGGCCGTTTCCTACCTCAGTGCTGG	Mycobacterium kansasii
TCACGTCGAGCATTGTGTCCGGGGCTACTCC	Mycobacterium kansasii
CACCCGCGACCGGGTCCGCGGCATCATTCAC	Mycobacterium kansasii
CGGAGGAGACATTGCAGGAGACCGAGGCGCG	Mycobacterium kansasii
TGACCTCGGCGTCGCCGCGCTCAACGGACTG	Mycobacterium kansasii
AACCAGTTCGTGGCCGCCAGTACCTGCATCA	Mycobacterium kansasii
CCCGCGTCATCGATGACCGAAACAGCTCTGC	Mycobacterium kansasii
GGCGTTGGCCGGTCGACAGCGGGTAGCGCTC	Mycobacterium kubicae
TCACCAGGCCGGCGACCTCCTACACCGCGTC	Mycobacterium kubicae
CCGCGGTGTCGTCGCCGACCAGGTCGGTCGG	Mycobacterium kubicae
ACGCCGGCCAGCAGACCGTACTGGTGCACCC	Mycobacterium kubicae
AGTTGAGCCGGCCGCCCTGCACGGCCAGGTC	Mycobacterium kubicae
CGGGTGGACGTCACCTTGACCTGGTTGCCCG	Mycobacterium kubicae
GGCGCGTTCCAGGGCCGCATGATCGACGCCG	Mycobacterium kubicae
TGAGTGGACAGCAGAGCCGTTTGGTGGATGG	Mycobacterium kubicae
GCCGCGCTGGCCCAAGTCCGACCCGCTGACC	Mycobacterium kubicae
GACGTTGCGACGGGCCAGGACGCGTTGCAGA	Mycobacterium kubicae
CTCGCGCTCGAAGTGGCCGCTCTTGATCGCC	Mycobacterium kyorinense
GGCTTGTCGGCGATCGGCCGCTGGAAGTTGA	Mycobacterium kyorinense
CGTCGATGAACACCTGGAATTGGCGTTCGGG	Mycobacterium kyorinense
CAGGATCTCGGTGCGGCGCGTCCCGTCGTCG	Mycobacterium kyorinense
GGGTCGTGGGTGGTGGACACGACGACGACCT	Mycobacterium kyorinense
ACGTTGATCACCCGCACAGCCAGGTCGGGCA	Mycobacterium kyorinense
GGCATTGTCAAGCTCGTCGCCGAATGCGGCA	Mycobacterium kyorinense
CTATCGTGAGAACGGTGACGCAGGTCAATAG	Mycobacterium kyorinense
GCGGCCACCGGCGCGCGGATGCTGACCACGC	Mycobacterium kyorinense
ACCCCGCGGGTGCTGTTCATGGAAGCCTCCG	Mycobacterium kyorinense
GAACCTCGATGTCGAGGCGCCGTAGGAGCAA	Mycobacterium lacus
GGCGGCTGCCCTCGGCGTTGGCCGGTGAATA	Mycobacterium lacus
CGCCTCAACGCGCGCACAGTCCTCGATCGCG	Mycobacterium lacus
TCGACGACGTTGTCTCCGGTGATGTTCGCGA	Mycobacterium lacus
CCTGTCAACCGGATCGGGGTTGCGGCCTTCT	Mycobacterium lacus
CGCCAAGTTGCTGGCGACGCCCGAGCTGCCA	Mycobacterium lacus
GCTGCCCCCGGGGATCGGCGTCGACTTCGAC	Mycobacterium lacus
GTGAGCGTCGTCTCAAGCCGGTCCCAATAGC	Mycobacterium lacus
CCGGTGCTTGGGCACTCGCCGGTGGGTCCGA	Mycobacterium lacus
TTCACCTTCGGTGCGCCGCCGCCGGATGTCG	Mycobacterium lacus
GACTTGAACGATGACGTACTGCCCGCCCCGG	Mycobacterium lehmannii
TGGCGGATTCACCCATCTCATCGACTCTCTT	Mycobacterium lehmannii
ACGCCATCGTCCACCCGTTGAGTCGACTCCT	Mycobacterium lehmannii
CTTATAAGTAGGCAGTTGACTGTCGCAGTTT	Mycobacterium lehmannii
CACGCGTCGGACACGCTACGGTCGGTCTCGA	Mycobacterium lehmannii
GGCGTTGACGGCGGCAAGGACATCGAGGTCG	Mycobacterium lehmannii
GGGGCGGTCGTTCGGTTCCGTCCGCGCGGTG	Mycobacterium lehmannii
TCGTTCGTTCTTGTGGTGCCGGGCGACGGGT	Mycobacterium lehmannii
ACTCGCCGACCACTTCCTCGACGTGCTTGGC	Mycobacterium lehmannii
GATGAGCCCCCATTTCAACGATGGCGCCCGC	Mycobacterium lehmannii
TTGAGACCCTTGAGCCGCAAGTCGACCACGA	Mycobacterium leprae
CGTGCGCGGCGGATCTCGTCAGCCTGTCGCT	Mycobacterium leprae
CATTTTCGACACAGGCCCGCTTCCTCCGCAC	Mycobacterium leprae
AGATTCCCATCAGCAGTTTCGCTGACAAGAC	Mycobacterium leprae
TTAGCTCTCACAGCGAAAATGTTTAGGCAAC	Mycobacterium leprae
AGCACAGCATCGGCGTCGGGTGCCCGCGACA	Mycobacterium leprae
TGCGTGACGGCTTACTGGAAAGTGGTCTGTT	Mycobacterium leprae
CTCGACATCGCTACCAGCGTGTAATGCCTCG	Mycobacterium leprae
GTCAGACCCGAACCGATGGCAACGTGCGCAG	Mycobacterium leprae
CGCCGAATTGTCACCGACGTCCGCTGCGCTC	Mycobacterium leprae
CATCATCGCCTGCGCGGGTCATCGACTTAAC	Mycobacterium lepromatosis
CCTCAGCGTAATGCCGATCTTGATCCATGCG	Mycobacterium lepromatosis
GGCTACCACGCCATCGGGTTGTGTGGTTAGC	Mycobacterium lepromatosis
CGTGACGGAGCTGCCTGCACTGCAGGAGGCA	Mycobacterium lepromatosis
CAGTACGATAGCACCCCAGCCGGCGATGATG	Mycobacterium lepromatosis
GCGGCTCGTTGGTGGTGCGTTCTCGCCTGAT	Mycobacterium lepromatosis
GCGCCGCGTGGCGGGCTTGCCAATGTCATGC	Mycobacterium lepromatosis
GGCGGTAATTCCTGTTACTGCGATGACATTA	Mycobacterium lepromatosis
CTCTGGGGACAGGGCCGGAAGACCCGCGACG	Mycobacterium lepromatosis
GAGTCTCGCTCAGCGCCACTTTGTCGTCGAC	Mycobacterium lepromatosis
CTGCCTGTACTTCTCCGCGGTGTCGCTGTCG	Mycobacterium malmoense
CGTGCCGCTATCCGGGCGGGGTCAATTCCCC	Mycobacterium malmoense
ACTGCCTGTACTTCTCCGCGGTGTCGCTGTC	Mycobacterium malmoense
TCCAGCCCGGCGCGGGCGTCGGATCGGCCCA	Mycobacterium malmoense
GAAGCGCACGGTGAACGCCCGGTGCCCGCCC	Mycobacterium malmoense
CGAGCACCGCGCCGAACTGCCCGACGTGAGC	Mycobacterium malmoense
CACCGCCGACCGCTGCCTGCAACTGCACGGC	Mycobacterium malmoense
TCGGCACCGGGACGGGCGGTGCGACGGTGGG	Mycobacterium malmoense
CGGTCCCGTCGCGGTCGCGGATCACCAGCGC	Mycobacterium malmoense
CGCGGCTTCGGTCCAGCCCTGGGGCACCGAC	Mycobacterium malmoense
ATCACCAGCCAGTCACCGACTTTTGCCTTCA	Mycobacterium mantenii
TACCCGCCCGTGTTCGTCGGCCGATTCTTCG	Mycobacterium mantenii
CCGGAAGTCCTTGAATGTCGACGCGGTACCG	Mycobacterium mantenii
GGCCAGCGCCACCCCCAACGCCTCGGCGTCA	Mycobacterium mantenii
CTTGAGCGCCGGGACGTCCGCGCAGCCGTCG	Mycobacterium mantenii
GCTGCTGCCGGTAGAGGGGCAGGGTGGGCAT	Mycobacterium mantenii
TTGCATCGTCATACGCGCGGGTCATCGACTT	Mycobacterium mantenii
GCTGATTGACCAAGGTGGCCGACAACGGATC	Mycobacterium mantenii
ACGGTGGGTCACCGGGTGGTCGGTGTGGACG	Mycobacterium mantenii
CGGCGGACCGTGCAGGCCATACTGCGATCGT	Mycobacterium mantenii
GTGGTGCAGACCGCGTAACCGCGATAGTTGG	Mycobacterium marinum
GGGCCGGAGGGTTTCGGGTTGTCCTCGGGGC	Mycobacterium marinum
GGGAATGGCGGCGCGGCCGGCGCCGGTGGCA	Mycobacterium marinum
GCGACCCGCCGCGGCGGCCGCGGAGTCGATG	Mycobacterium marinum
TTGAGCCGCAATGGATTTGAGCGCGGCCTAC	Mycobacterium marinum
CGCGGAAGGTAATCGTGGTCGCCGGCCGTCT	Mycobacterium marinum
GTCGGCGGCGCTGCCTGGCTGGTCGGCGCCG	Mycobacterium marinum
TTTCTGTGCCAAGGTGTGCGGGGCACCAGCT	Mycobacterium marinum
GCTGACGCAAGTACCCCAGCAGGCGCTGCAG	Mycobacterium marinum
CGGCAGCGGCGGCGAGGGGGGCGACGGCGGG	Mycobacterium marinum
CCTCCCCGGCCTCCGCCGCATGGCGCGAACT	Mycobacterium marseillense
CGGGAGACTTGTGGCGCATGACGTCCAGGCC	Mycobacterium marseillense
GACGCAGAAGGTGATGCGCCATGAGGTGTTC	Mycobacterium marseillense
ACCCGTCCCGCATGGAGGGGGCAGAGTTGCG	Mycobacterium marseillense
TGGCGTTGATGCCCATCCCCATATCCAGGGC	Mycobacterium marseillense
GGCCGAGCGTTCGGCCGCGCACAGGCGCTGG	Mycobacterium marseillense
ACGCTCCGCAAAGACTGCGATCGGCATGACT	Mycobacterium marseillense
GTGTCGATGTAGTCGGACACCGCACGCACCC	Mycobacterium marseillense
GATCACCGCCCCGACCGTCGCGATGGCCTGC	Mycobacterium marseillense
GACGTCCGCGGACACCACCAGGCTGACGTCC	Mycobacterium marseillense
TCGTCAGCTGACCGGTCCGGCCGCGGCCGCG	Mycobacterium nebraskense
TGTTGACGACGAAGGAGCCGTCGGTGGGCGG	Mycobacterium nebraskense
GTCGACCGACCGGCGCTCAAAGACCGGGCAT	Mycobacterium nebraskense
GTGCCGCCGCATTCCACGACGGCCGCCGGCC	Mycobacterium nebraskense
CGTGCGACCCTGTCTCGGCCGCCGACACGCT	Mycobacterium nebraskense
CGTCCTGGGCGGTGCGCTGAAAGACACCCAG	Mycobacterium nebraskense
TCGGCGGTGCCATCGACGCCGAGGCCGCCGA	Mycobacterium nebraskense
TCGTATCCCGTGCACCCGCCGGGCAAGCCGG	Mycobacterium nebraskense
CGGGCCGCAATCAGACCACCTGGATGCTCTG	Mycobacterium nebraskense
ACGATGACCACGGCGGTTCGAGCATCGGGCG	Mycobacterium nebraskense
GACGCGCAATTCGTCGGGGTGGTCGAGGTCC	Mycobacterium noviomagense
GATCGACTCCGCCGCTGTCGACCGGATCTGG	Mycobacterium noviomagense
TCGGGCAAGGATGATCGAGAGAGACTTGCGC	Mycobacterium noviomagense
GACATAGAGGATCGCCAGGGCGCAGGCCAAT	Mycobacterium noviomagense
GCCGTGCGCTCACCGAGGTGGTCGCGAGGCA	Mycobacterium noviomagense
ACGGGCCGGCGTGGAGATCGCGATCGACGAC	Mycobacterium noviomagense
ATCGCGCTGGAGAATCTGCGGGCCCGGTTCA	Mycobacterium noviomagense
GCTTTGGTGGCCGAGGTGGACGACCACAATC	Mycobacterium noviomagense
TCAGCGACGAACGCGGCCTGCCCGCGCAGGC	Mycobacterium noviomagense
CGGCAGCTCAGGTTTGAAGAATCCCATGCCG	Mycobacterium noviomagense
TGCCCCGGGTGCACCGGTCTCCGTCCCGAAT	Mycobacterium orygis
GTCCCGCCGCGCGGCGCGAGTAGCTGACCCG	Mycobacterium orygis
CTCCGGCGCTCGTCGGCACCGCGGATCGCAT	Mycobacterium orygis
CTGGCCCGCGCCACCGCCTCGCGCAAGCTTT	Mycobacterium orygis
TCGCCACTATGGCCGGTGGCTGGCGGCCAGC	Mycobacterium orygis
TTCAGTCAGTTCTCGCGCCAACAGCACGAGG	Mycobacterium orygis
AAGAATCAGGCAACACGCAGCACGACGCAGG	Mycobacterium orygis
AGTTCGACTGGCGTTACCCATCGTCCCCGCC	Mycobacterium orygis
CCGGCCCAGTGATCGGTCGCGGACACCATGT	Mycobacterium orygis
CGCGTCGGTTGCGCTGTTCGCCCCAATCCCG	Mycobacterium orygis
GACTTTCCCGCGGATGCCTTCGTCGCGCGCC	Mycobacterium ostraviense
CCGCAATGACGGTGGGCGAGTGGCTGGTCTG	Mycobacterium ostraviense
AGCAACAACAGCTGGCCCTCGGCGCGGTCGC	Mycobacterium ostraviense
CTCACATACGAGTGCTCTTCGCCTTCGACAT	Mycobacterium ostraviense
GCAGGTCCACCTCGGGGAGCTCCAGCGGCGG	Mycobacterium ostraviense
GGGTGGCCCAACGCGGGCAGATAAGGACGTC	Mycobacterium ostraviense
CTACTTGGTGCGGCTGGCGGCGCTGGCGGTA	Mycobacterium ostraviense
GGAGAGCAGTCGCGGCGGCCGGCGGGCGTAG	Mycobacterium ostraviense
AGCGCGCGGAAGCTATTGACCTGCTTCGGGT	Mycobacterium ostraviense
GCTCGTATTCGCTTACCGCCCAGGGCAATAG	Mycobacterium ostraviense
CTGACCCAAACCCAGTTCGCCGTCGGCGTGC	Mycobacterium paraense
CAGCGCCAGCCCCGTGTCCGCCTTGAGGCGG	Mycobacterium paraense
TGATGCGCACGCGCGTAGAAGCGCCCCCGGT	Mycobacterium paraense
AGCCAAGGCCGAACGCCCGGCCCCGAAGAAG	Mycobacterium paraense
GAGAAGGGAAGTCAGATGTCGAACGACAACA	Mycobacterium paraense
GATCCTGGAGTCTCCATGGAATCCTTCGTCC	Mycobacterium paraense
CGGGAGCCCGGCGCAAGCTCGACATGGCGTC	Mycobacterium paraense
GATGGCGATGCCGCCCATCGAGTGACCGGCC	Mycobacterium paraense
GGCCTGGATCGACGGCCGGTCGGCCTACCGG	Mycobacterium paraense
GATCGTCATGCCGGTATTGACCGATGGCGGC	Mycobacterium paraense
GGAGTCTCGGTGCTGTGCCCGATGGTCGTCG	Mycobacterium paragordonae
CCGGTGTCGGGGTTGCTGCAGACGCTGGCCA	Mycobacterium paragordonae
AGCACCGCCACGGCGGCGGCTTTGACCAGCG	Mycobacterium paragordonae
TGCGGACCTTCCCGGTCGCCGTCATCGGAAA	Mycobacterium paragordonae
CCCTCACCGCCGAGGCCGGCTACCGGACTGC	Mycobacterium paragordonae
GAACTGGGCCTGAGCTACCTGTTGCCCAGGG	Mycobacterium paragordonae
GCCGGCACACCACACCACGGTGGCGGTGTCG	Mycobacterium paragordonae
GGCACCACCGAGGATTTGGTAGCCGACGCGC	Mycobacterium paragordonae
CCCGGGCCTGCTGGCCCGCGCTCACGGCGGC	Mycobacterium paragordonae
CGAAACATCTATGCTTCTCAGGCATGACGGA	Mycobacterium paragordonae
TTCCGGAAAGTAGTCGAGCAGGGTCGCCGGC	Mycobacterium paraintracellulare
CATGGTCTTTCCAGTGCCGGTCTCCCCCGTC	Mycobacterium paraintracellulare
TCGTCGCCGCGTGGGTGTTGTCGGCCCGGTT	Mycobacterium paraintracellulare
ATCAAAAAGTCTTCCGGAAAGTAGTCGAGCA	Mycobacterium paraintracellulare
AGCTCTGCCGTCGCGGTCGGGGCGATGATCC	Mycobacterium paraintracellulare
GGCGACGGCCGACAGCGCGAGGCCCAGCATG	Mycobacterium paraintracellulare
CCATGGTTTCCCGAAGCCACGACGCCGCGAC	Mycobacterium paraintracellulare
CAAGCGCCGCGCGAAGCCGCAGCAGGCGGAC	Mycobacterium paraintracellulare
GGCGGCGCGCCGCTGGCCGCCAGGGCCGGGC	Mycobacterium paraintracellulare
CTTCGCGGGCGACGAACTCACCGACGAGCCC	Mycobacterium paraintracellulare
CTTCGAACAGAGAAGGGACATGATGACGAAA	Mycobacterium paraseoulense
GCCGCGTGCTCGCCGCACCCGGCGTAAGCCA	Mycobacterium paraseoulense
GCGCTGACGCCCAGTTGGGCCAGCCCCAGGA	Mycobacterium paraseoulense
CGGCCTCGCCCTGTTCGCGGTCACCTCCGGT	Mycobacterium paraseoulense
TCCTCGCTGTCGAGCGGAACGATGGTGTGTT	Mycobacterium paraseoulense
CGAACTCGCCCGGAACGTCGGTGTGCGGAAG	Mycobacterium paraseoulense
GCCGCAACGGTGATCGTCGGGATCGGCGCGG	Mycobacterium paraseoulense
CGCCCCGCCCTTGCGTTAACGGTCGTCGCGG	Mycobacterium paraseoulense
TGGCCGGCGAGATCGCCGCTCGAGGGGCCGG	Mycobacterium paraseoulense
GGCGGCCAGCACCTTCGCCGCGCGGATGACA	Mycobacterium paraseoulense
CTCGCCCAGCCCCTGGACCCGGAGCGTGACG	Mycobacterium parmense
CGATCAAGGGCGTCGACGAGCAGGGCCGCCG	Mycobacterium parmense
GGCCGGTTCCAGGTTCTCCTCGCCCATCAGC	Mycobacterium parmense
CGCTGTTCCTTTCGTGATCTGAATGCGCCCG	Mycobacterium parmense
AAATACTTCGCCTCGATCACCAGGCCCATGA	Mycobacterium parmense
GGAAGCGCCTCGCCGCGAGCATGCAGGAGAA	Mycobacterium parmense
CGCCACCACCGCGGCGCCGCCCAAAACGATC	Mycobacterium parmense
GTAATCCATGACCGTTTCTCCGATCCGGTCG	Mycobacterium parmense
AACTCGACGGCGAACTGCTGTGCGGCCCCGC	Mycobacterium parmense
GGCCGCTAACGATCAAGCCGCACAGGATCAA	Mycobacterium parmense
CGATAGCCGACCACCGGGTCACCGTGTTGTG	Mycobacterium persicum
CGGCGGGGAACACGTTCTCACCGCCGGAAAC	Mycobacterium persicum
ACGGTGACGGTCTCGCCGGCCAGCTTCTGGA	Mycobacterium persicum
CGGGAGTCACCGGCACCAACTTGTTGTCGCG	Mycobacterium persicum
GCGTTCGCTGAAGACGTCGCCGGGCAGTACG	Mycobacterium persicum
TCCGCTGGGATCACCCCCAGCGCGAAAGGAC	Mycobacterium persicum
CCATGGCGGACCGTCGTCACGGTGTCGCCGA	Mycobacterium persicum
CCACCACCTCAGGGCCGATGAGATAACCGCC	Mycobacterium persicum
GCCAGCGCGGCCAGAGACCGCGCAGCGGAAC	Mycobacterium persicum
GATGACGTCGGCGGCGTTGCGATACGCCATG	Mycobacterium persicum
CGGACTCAAGCAACCCGGCGGTGTCACCGTG	Mycobacterium pseudokansasii
GGCCATCGGCTGCCAACGGCGTCGGCTCGGC	Mycobacterium pseudokansasii
GAGGTTGACCGGGCCGCTGTCATGGCATGCT	Mycobacterium pseudokansasii
GTCCGGAAAGGCGAAGGGTACGTCGTCCGGC	Mycobacterium pseudokansasii
CTTGACCAGGTAGGGCGACACGGTACTGCGA	Mycobacterium pseudokansasii
GGAGTCGTTTTTCCGCGGAGCCGGCTGGAAC	Mycobacterium pseudokansasii
ACAGCGGGTGCTGGACCGGGATATCGGCAAT	Mycobacterium pseudokansasii
GGTGAGGCCGATTCCGTCCCCACCGGATTTG	Mycobacterium pseudokansasii
ACCTGCAGCGGTATCGGGTCCGGCGAAGTGT	Mycobacterium pseudokansasii
CGACCCCGCGCATCGTGGCGAACACGTCGAC	Mycobacterium pseudokansasii
GACTACACGGCGGATTGGAGGCTACGGCATC	Mycobacterium pseudoshottsii
GCCACCTGCAGGCCCTTGAGCTGATCGGCCA	Mycobacterium pseudoshottsii
GGTTCAGCTCCGGGGCCAGGATGAGCGCCCA	Mycobacterium pseudoshottsii
CGACCATTCCTGCGTGATGTTGCTGTCTAGG	Mycobacterium pseudoshottsii
CCAGGATCGATGCGGTGGGCAGTGCGATGAT	Mycobacterium pseudoshottsii
CCCACCTGGCCCAAGTACCTCGCCGATACGG	Mycobacterium pseudoshottsii
ACTATCCGATCGTTCCGGTCGGACTGGCCGG	Mycobacterium pseudoshottsii
TCGCGGCCGGGTGGCCGATCGGAGTGCCCAA	Mycobacterium pseudoshottsii
GTCCGGTTGCGGCGGTGGTGGCCAGGGGAAC	Mycobacterium pseudoshottsii
GTATTGCCGTCACCGCCGGATCCGTCATTAC	Mycobacterium pseudoshottsii
GAAGTTCGGGTGACATGAATCCCATGGCGGC	Mycobacterium riyadhense
TACCTGGACGATGCGCCGCGGCTGGTGCACA	Mycobacterium riyadhense
GAAGATTTCACGGTCGCGGGGTTGCCCGGGT	Mycobacterium riyadhense
GCCGTCCGGAGGCCGCGATGTGGAAGGCCTC	Mycobacterium riyadhense
GGCGCCGAGGATGTTGACAAGACGCTGCAGC	Mycobacterium riyadhense
CGAGGTGCTTGGCCACCCCCAGCGCGTTGGG	Mycobacterium riyadhense
GCGCCGTCGCCGAACGGCAGCCCGTACAACT	Mycobacterium riyadhense
TTATATTCGCCGAGACCGCCACCTTCGGGCC	Mycobacterium riyadhense
AAGCCGGCGGTACCCCCACCTCGGGGAAGAC	Mycobacterium riyadhense
GCAGACCGACCACGCGACGCCCTCCCAGACA	Mycobacterium riyadhense
CGGATGCCTTCCCATCATCCCGCTGCCGGGC	Mycobacterium saskatchewanense
TTGCCCAGCCCGATGTAGCCCAGGTGCACCT	Mycobacterium saskatchewanense
GCGTCAGGCCAAACCGAAGAGTCGAGCGGCG	Mycobacterium saskatchewanense
CGCCCCGGGCGGTAAGATCCCTTGGTACAGC	Mycobacterium saskatchewanense
AGTTTGCCCTGCAGCTGGGGGTGGACATGGT	Mycobacterium saskatchewanense
GGGCTATCGCGAGCTTGCGGCTCTCTTGGAC	Mycobacterium saskatchewanense
AAGACATAGGGATAGACGTCGGCCCCGGGCT	Mycobacterium saskatchewanense
ACGCACTGTTCGGCGGCGCCGACCCCGGCAC	Mycobacterium saskatchewanense
CGCCGCCGTCTATCCGGGGTTGGTGGGCGGG	Mycobacterium saskatchewanense
GCACAACAACTCGACGTTCGGCGGAACGTGT	Mycobacterium saskatchewanense
AGGACACCCCCGAGACGGGCTGGCAGGTGGG	Mycobacterium scrofulaceum
TCGACCCCCATCATCTGCTGGATCGCCTTCG	Mycobacterium scrofulaceum
CGGTGGCGCTGACGTTCGACGGCCACTCGAT	Mycobacterium scrofulaceum
GCGGGCCGAGGGGAGCGGTGGCGCCGGCCAC	Mycobacterium scrofulaceum
CGGGTTCACCGCGGTCAACGTCTGTTCGGGG	Mycobacterium scrofulaceum
TCGCGTCCGATGCCCAGCGAACGCAGGTAGG	Mycobacterium scrofulaceum
CGCCACCGCAAAGCGCAACTGGGACCATGAG	Mycobacterium scrofulaceum
AGCGCATGGTAGTCGAGGGCTCGGCCGTCGG	Mycobacterium scrofulaceum
CGTTGCGCCCGGCTCCGCCGCGCTTCCGGTC	Mycobacterium scrofulaceum
AGCAGACGCTGTTGCTGGACGACCGGACGCG	Mycobacterium scrofulaceum
GCGCGCCCAGGCAATAGTGAATCCCACGACC	Mycobacterium sherrisii
GCGTGGCCGGAACCAGCGGGTGCGCGGCGGT	Mycobacterium sherrisii
GCGGTAGGGCTGGTACAGGTCGATGGTCAGA	Mycobacterium sherrisii
GCTCGTCCCCGGCAATGCCTTCGGCGTGCTC	Mycobacterium sherrisii
AAAGCCGCGACATTCGGAACCACGGCGGAGG	Mycobacterium sherrisii
CCATTCAACATGGGATTGTCGACGATGTGTG	Mycobacterium sherrisii
TCGAGGCCTTCGGCCGCCAACTGGCGTTTAA	Mycobacterium sherrisii
CGCGCGATCCCCGGCTGGCCCGTTCGAATCT	Mycobacterium sherrisii
GCGATCCGCGGGACGCAGGGCCAACCGATCT	Mycobacterium sherrisii
TTGACGTCCGCCCGTTGCGGGCCCGGGTGCC	Mycobacterium sherrisii
CGGTGGCCGGCCTGCTGTCCGGGGACACGCC	Mycobacterium shigaense
ACGGTGCTTCCCTGCAAACCGGTTCGCAGCA	Mycobacterium shigaense
GGGCTGCGCGGCGCGAACGCTGACCGCCGAC	Mycobacterium shigaense
GCACTGCCGTGAGCGTCATCGGCCAAGAACA	Mycobacterium shigaense
GGGCGAGGCGGTTCGCCCCGTACGAGGGATA	Mycobacterium shigaense
TCTGAGACATGCGCATGTTGGTGCCCTGCTC	Mycobacterium shigaense
TGGCGACCGCCGAGAAGGAGAAACGCCGGGC	Mycobacterium shigaense
AGCCATGCTCACCGAGGCGCTGCAGTTCGCC	Mycobacterium shigaense
TTCTTCGAGATCGCCGTGACCCCGGAACGGG	Mycobacterium shigaense
AGTGCCGCGATCCAATACCGCGGCATGGCCC	Mycobacterium shigaense
CCAGCTTCTCCGCCCGGGAGATGCTGCGGGC	Mycobacterium shimoidei
CGCTGGCATCGCTGGCCGCCGAGCTCAAGGT	Mycobacterium shimoidei
TGGTCGGCATCGCAGTTACCAGCCAACAGAC	Mycobacterium shimoidei
AAGGTCATCGACCGCAAGAAGGAACTCATCA	Mycobacterium shimoidei
GCGGCCTCGTCCAGGGACTGCCGGGCCCGTA	Mycobacterium shimoidei
GGATGACGGCCAGCACCACCGGCCCGCCCAA	Mycobacterium shimoidei
CGCGATGTCGCGCGAGTACCTCGGTGCCGAG	Mycobacterium shimoidei
GCGCGTTGCTCAACGGCTTCACCCCAGCCTG	Mycobacterium shimoidei
TGCGACCGACAAATTGGGTGGCGTTGTCGAT	Mycobacterium shimoidei
ACGCCTGCGCCGCCGCCCGGCATCGGCCATC	Mycobacterium shimoidei
GTGTGGGCCCGGTTCAGCCGGCTGCTTCCAG	Mycobacterium shinjukuense
ACCTGGCCTTCGCCGGCATACCCGGGGTGGT	Mycobacterium shinjukuense
CGCACCGTCGAGGCGTACGTGCTCGACACCT	Mycobacterium shinjukuense
TAGTGCCCGCGGGTATCGTCAGTGACGGAAT	Mycobacterium shinjukuense
ATCCTGTCGCGTCGGGGTAAGACGATCCGGC	Mycobacterium shinjukuense
TGATGGCCACCAATTTGGGGATGTGGTCGTG	Mycobacterium shinjukuense
GCGTGACGAGGCACACCGATTCGCCATCACC	Mycobacterium shinjukuense
GACCCACCGTGATGCTGTGCGCATTTCCGGT	Mycobacterium shinjukuense
AAGTACTACACCGAAGAGGAGTTGGCCGAGC	Mycobacterium shinjukuense
GATTCGTACCTGGTCCGACTGGTTCGACAAC	Mycobacterium shinjukuense
CATCTGGCCGCGCGGTTGCGCCGCAACAGCG	Mycobacterium simiae
CGCCCAACCTGCCCAGCGGCTATGCGTCGAT	Mycobacterium simiae
GCGACGAGTCGGGAGTGAAGATTTCGTCGGC	Mycobacterium simiae
CACGGAGTTCCTGCCCGGTTCGCTGATCGAC	Mycobacterium simiae
ACCGGCGTTGTACTGGTCGCCGGAGAACCGC	Mycobacterium simiae
ATGTTGAGCATGACGATCAGCAGCGGAAATT	Mycobacterium simiae
GACCGGCGTTGTACTGGTCGCCGGAGAACCG	Mycobacterium simiae
TGCCCAGCGGCTATGCGTCGATGATCTCGCT	Mycobacterium simiae
GGGTGTGCAGGATGTCGTCCTGGGGCACGAA	Mycobacterium simiae
CTCGGTCCGATGGCTCGCATGCTCAAGGCGG	Mycobacterium simiae
CCGGTGGCCATCGCGACCGTCATCGCCCACC	Mycobacterium simulans
GGGTCGATTGTATATGCGTGTGCGAACGCAT	Mycobacterium simulans
GATAGGTCGCCACCAAAGGGGCCGCGGCCAA	Mycobacterium simulans
GCCGGCAAAGACGACATCGAGTACCTGTTCG	Mycobacterium simulans
CGACCAGCCCGACCGGGTGTACTGACTGTGA	Mycobacterium simulans
AGCTCCGACATCGCGAGCCGTTCCGATCCGT	Mycobacterium simulans
CCGACCGGTTTCCACTACGACTTTCGCACGC	Mycobacterium simulans
CGCCACGTTCCTGGTGCCGACGATGCTGCAG	Mycobacterium simulans
GCCGTCGGCGGGGAATTGGCGGCGGCGACCG	Mycobacterium simulans
CAGGCGCTGCAACGGCGAAACGTTGGCGGCC	Mycobacterium simulans
ACGTCGGTCAGTGAGCTGACGTCGAGATGCG	Mycobacterium syngnathidarum
CTGAGTGCGTGTCTCGGACGTCGACTTCTTC	Mycobacterium syngnathidarum
ACGCCGCAGCACCGCGCACGCGATACCCTCC	Mycobacterium syngnathidarum
ACACCGATGGCCACGTTCGCCGCCGTGAAGA	Mycobacterium syngnathidarum
CGGTCAGCTTCTCGCGTGGCACGCCCTTCTT	Mycobacterium syngnathidarum
CGACGATCTCGACCGCTTGGCCGGCCAGGCC	Mycobacterium syngnathidarum
ACCGAACAACGCTGATCCGACTGCCAGCCGG	Mycobacterium syngnathidarum
TCCGCTTCCTGCTCACCGCCGGGGCCATCGG	Mycobacterium syngnathidarum
TTCCGCCAACTTGGTTTGCATGTGTTTCCAT	Mycobacterium syngnathidarum
ACTGGCACCGTGCGCATGCTGCTGCACGTTG	Mycobacterium syngnathidarum
CCGAGCTCGCGTTGTCAGCCGCGCGCGGGAA	Mycobacterium timonense
ACGAGGCGGTAACCGAGCTCGCGTTGTCAGC	Mycobacterium timonense
CGAGGCGGTAACCGAGCTCGCGTTGTCAGCC	Mycobacterium timonense
TCTTGAAGTCGGTGTGGGTCAGCGAGGCATA	Mycobacterium timonense
GGGTAGTTGTCCTTGATGTAGCCGGTGAGCA	Mycobacterium timonense
CTGGCGCACCGCGACGACGTGCCCGGCGGCG	Mycobacterium timonense
TCCTTGATGTAGCCGGTGAGCAGGTTCTGCC	Mycobacterium timonense
AGTGGGTGAATCGCTGGACCGCGGAGGAGGC	Mycobacterium timonense
CCCTGGCGCACCGCGACGACGTGCCCGGCGG	Mycobacterium timonense
CAGTGGGTGAATCGCTGGACCGCGGAGGAGG	Mycobacterium timonense
TGAATGCGGCCTGCGTCACGAAGGTGGCCAG	Mycobacterium triplex
ACGCGCTGCTGGCAGCCCTGGCAGGCCTGTC	Mycobacterium triplex
GGCGCACGCAGGTTGATCGCCATGTGGCGAT	Mycobacterium triplex
GCGCTCAGTACCTCAACGAGCATTAGCAACT	Mycobacterium triplex
TCAGAAATCGGGGCCGAATTGGGCTCCGGGG	Mycobacterium triplex
TCGGCATACCGGTCATCCTGTTGCCGTTCAT	Mycobacterium triplex
GTTATTTGATCCGTGCTGCCAACGGCGACGA	Mycobacterium triplex
CGGTCAGCATCCCCGCCAGCGCGATGGCGCC	Mycobacterium triplex
AACTCGTCGAGCATCTTGCTCGCTTCTTCGA	Mycobacterium triplex
ACGCCGGCGCGGTCGGTGACGTCGACACCGA	Mycobacterium triplex
CCGATGGCCGCGGCCAGTTTCACGGTGTCGT	Mycobacterium tuberculosis
TGGATCTCGTTGGTGCCTTCACCGCCGTTCC	Mycobacterium tuberculosis
AGAGGGGCAATCCGGCTCACTCGCTGGCCGA	Mycobacterium tuberculosis
CGACGATCCGAGCGGCCCGAGCCCTGCTGGA	Mycobacterium tuberculosis
CGACCGTCACTCGATCACGTATTCCTGGCCA	Mycobacterium tuberculosis
CGGTCGTCGGGGCCACCGTCTCACAGTGCAC	Mycobacterium tuberculosis
CAGAACGCGTTTGGAGCGTAGATTTTCGGAG	Mycobacterium tuberculosis
AGCCGCACAACGCGCCGAGAGCTCTTGGCAA	Mycobacterium tuberculosis
CCGGCCAAGCGCTGGATGCGTCCGGGTACTG	Mycobacterium tuberculosis
AGCGCGCTCGGGCCGGCCATGCCGATGTCCT	Mycobacterium tuberculosis
CGCACCCAGGTTGACGTTCCCCACGTTGCCG	Mycobacterium tuberculosis variant africanum
CGTTCCCCACGTTGCCGAAACCGACGTTTAC	Mycobacterium tuberculosis variant africanum
CCAGGTTGACGTTCCCCACGTTGCCGAAACC	Mycobacterium tuberculosis variant africanum
CCGCACCCAGGTTGACGTTCCCCACGTTGCC	Mycobacterium tuberculosis variant africanum
CCCACGTTGCCGAAACCGACGTTTACGCTGC	Mycobacterium tuberculosis variant africanum
TCCCCACGTTGCCGAAACCGACGTTTACGCT	Mycobacterium tuberculosis variant africanum
GGTTGACGTTCCCCACGTTGCCGAAACCGAC	Mycobacterium tuberculosis variant africanum
TATTGGCCGCACCCAGGTTGACGTTCCCCAC	Mycobacterium tuberculosis variant africanum
TTGACGTTCCCCACGTTGCCGAAACCGACGT	Mycobacterium tuberculosis variant africanum
TTCCCCACGTTGCCGAAACCGACGTTTACGC	Mycobacterium tuberculosis variant africanum
CAACTGCCGCTGGCTGACTAGCAGTCGCACT	Mycobacterium tuberculosis variant bovis
GCCCGCGCAGCAGCGAGGTCATCGTTCGCAA	Mycobacterium tuberculosis variant bovis
ACACCGCTACCGCGGGCTCGTTCTCCAGCTC	Mycobacterium tuberculosis variant bovis
TTTGGCGCATTCGCCGCCATCGCGCGTGCTT	Mycobacterium tuberculosis variant bovis
TCCTGTCCAGGATGGGCATGTCGGTCGGGTT	Mycobacterium tuberculosis variant bovis
GGGTGTCTCGTACCGTGCAGGAAACTCCCTT	Mycobacterium tuberculosis variant bovis
GGCCGCCCAGCAACACGCCGTCATCGAGGCC	Mycobacterium tuberculosis variant bovis
CGGTGGTGGTGGAGCCGGTATGGTAGCTACC	Mycobacterium tuberculosis variant bovis
TCACAGGTGGGCGTTGGCCGCGATCTGTTTC	Mycobacterium tuberculosis variant bovis
ATCGCCCAGGTCAACACCGAGGCGACCAGGT	Mycobacterium tuberculosis variant bovis
CCAGCGCTTCGCGCATCACGTGGGCGGCGGC	Mycobacterium tuberculosis variant microti
CGCTTGGCAACACTGCGGCCCAGCCCCGGTG	Mycobacterium tuberculosis variant microti
GGCGTATCGGGCCCCCTGGATCCCGCCCTGA	Mycobacterium tuberculosis variant microti
GCGCTCATGGTGTCCAGCGGGGACGATGCGG	Mycobacterium tuberculosis variant microti
GCTCGCCGTTGTAGACGCCGATGGGCGCTTT	Mycobacterium tuberculosis variant microti
AGATGGCCGAGACGGTCGCGTCATTCTCCCC	Mycobacterium tuberculosis variant microti
TCCGCTGCGGGTGGCAATTGGTAGGCGCCGA	Mycobacterium tuberculosis variant microti
AAGTTGGGGCCGGAACCACCTACGCCTGGGG	Mycobacterium tuberculosis variant microti
TCGACGGGGTTAGCGTGTTGGCGCAGATGGA	Mycobacterium tuberculosis variant microti
CATGACCGCGCCGCTGCTAGTGCTGCACGGC	Mycobacterium tuberculosis variant microti
TTACCTCAACGCCGACCCGCTCGGGCCATAC	Mycobacterium tuberculosis variant pinnipedii
TCGCCCGCGCGGGCCGGTCCGCGGGAGCGCC	Mycobacterium tuberculosis variant pinnipedii
CGGGCGTCACGGCCGCACGCAAAAGCGGATT	Mycobacterium tuberculosis variant pinnipedii
CGGCGCGCTGGGCTGCCTTGATTGCCGCGTA	Mycobacterium tuberculosis variant pinnipedii
CCAGGCCATCTGCGATGGTGGCTTCTCCCTC	Mycobacterium tuberculosis variant pinnipedii
TAGATAACGAACCACGCGACGCATGGCGTCC	Mycobacterium tuberculosis variant pinnipedii
AGTCCGGCAGCTCCCCACCGGGCCACGGCGT	Mycobacterium tuberculosis variant pinnipedii
TTGGTGGGAAGCGGGATTGCCGAGCACACCG	Mycobacterium tuberculosis variant pinnipedii
CGCAAAAGCACCCTGTTGCGGCGCAAAAGTG	Mycobacterium tuberculosis variant pinnipedii
CGTCCACGACGTTGCCGTGATATCCGAGGCG	Mycobacterium tuberculosis variant pinnipedii
GCGCAAGTTGGTCGGGGTGTTCGATCAGTGC	Mycobacterium ulcerans
GCCACCGGCGACCGCAACTGCAGGCCGAGTC	Mycobacterium ulcerans
GATGTCCGACAGCGGTTCACCGTCGATGCGG	Mycobacterium ulcerans
CCAGACCCGCGGCGCCGATGTGCTCGCCGAC	Mycobacterium ulcerans
TCATTCCGCCGTTCACCGACTTGCGTAGTGT	Mycobacterium ulcerans
GTTCGCTGGTCGACGCAGACGCAGACACAAC	Mycobacterium ulcerans
CGCAAATGGCGTCGTCGTCATTCTTGGTGCC	Mycobacterium ulcerans
TCGCTGCCTTCGACGCGGCGAGGGGGCCACC	Mycobacterium ulcerans
CGAAGTCCTTATCGAGGGCGTCCAGGGCCTC	Mycobacterium ulcerans
TGATCTCAGGTGGCATGACAGGGCTCCGGCG	Mycobacterium ulcerans
GGCGTGGACGCCCGCGACACATCCCGCTGCA	Mycobacterium ulcerans subsp. shinshuense
GTCCTTGAGTCCGACGCCCTTGTACACGGCC	Mycobacterium ulcerans subsp. shinshuense
CTGAATTAGTTGAACGGCAATAAGACCGACT	Mycobacterium ulcerans subsp. shinshuense
GGGGCCAAGTCCCGGGCGGCCAGATAGATCA	Mycobacterium ulcerans subsp. shinshuense
ATTATAAACCTCGTCTTAGGTTTTTGTGGGG	Mycobacterium ulcerans subsp. shinshuense
GTATCCGCTCTCGGAGGTGGCTGGCAACCTC	Mycobacterium ulcerans subsp. shinshuense
TCGGTGTGCTGATTGACCAGAAATGGAAATA	Mycobacterium ulcerans subsp. shinshuense
GAAAGCCTTCAAATCCGCTCCCGCGCAGAAT	Mycobacterium ulcerans subsp. shinshuense
CTCTCCGAGTGTCATTGATAACCTTCAGAGA	Mycobacterium ulcerans subsp. shinshuense
CGCCCTCCCAGACCGACCTCGACCACCGCGA	Mycobacterium ulcerans subsp. shinshuense
CTGCTCCAGCGTGTAACCGGTGTCTTCGACC	Mycobacterium xenopi
CGACTTGCCGGCGCCGTTTGGACCCAGCACG	Mycobacterium xenopi
CGCCGATTCGAGCGAAACATGTTGCGGCGCT	Mycobacterium xenopi
TGGGCGCGGCCTACGGCGGCGCGCTCGGCGT	Mycobacterium xenopi
ATTCGGGGTGTAACTGTTCGATTCCCACACC	Mycobacterium xenopi
GCGCGTTCGAGCCAGCGCCCTCGACCGCTCC	Mycobacterium xenopi
CGGTGTCGAGCAACCGCTTGACGATCTTTAG	Mycobacterium xenopi
AACGGCCGGGGCAGCGCGGCCACGTCGACGT	Mycobacterium xenopi
GCGTCTTGGACCGAGCCCAAAGGCGGGTATT	Mycobacterium xenopi
ATCGGGTCGACGAACGCTGCTCCGGCACCGT	Mycobacterium xenopi
CAGCTCGGCAGGGGCCGCACAGACATCGTCC	Mycobacteroides abscessus subsp. abscessus
ATAGGTCCATCCGACCACCAGCCGGATGGGT	Mycobacteroides abscessus subsp. abscessus
CGTCACGTAGTTGCGCCAGTTTTGCCAGGAT	Mycobacteroides abscessus subsp. abscessus
CGGGCGATGAGTCGCTCACGGTGAGCAGGGA	Mycobacteroides abscessus subsp. abscessus
GACTCGCCCATCGCGCGAATACCGGTCGCCG	Mycobacteroides abscessus subsp. abscessus
CTCCGCGGGCTTCGGAGATGAAGGACCCGCT	Mycobacteroides abscessus subsp. abscessus
GGACCCAAGAAGGTGGACGCAGGGGTGCTGT	Mycobacteroides abscessus subsp. abscessus
GAGCCGCTTGGCCTCATCGGTCAGGCCGGGC	Mycobacteroides abscessus subsp. abscessus
CAGGGCCGCGATCCAGTCATCCCGAAGGTCC	Mycobacteroides abscessus subsp. abscessus
CGAAGTCCTCGCGCCGCAGCTCGGTGTAGTA	Mycobacteroides abscessus subsp. abscessus
TTCAGCAGCTGAGCTGCTCGACGGCCTGGAG	Mycobacteroides abscessus subsp. abscessus
GAGTGCCGTCGGTTATTCGTGCCCGGCAGTA	Mycobacteroides abscessus subsp. abscessus
AGATCGCCCCAACCGGCCGCCTCGCGCAACC	Mycobacteroides abscessus subsp. abscessus
TGGGGCCGCATCGGCGTGCCCGGCCAGCCCT	Mycobacteroides abscessus subsp. abscessus
GACGTCTACCGCAGTGATGTCGGCGTCCTTG	Mycobacteroides abscessus subsp. abscessus
TCTCTTTGCCGTCCACGACCACTTTGGCGCT	Mycobacteroides abscessus subsp. abscessus
TGACCGCCGGCCAGGTAGCGCCGTCCCAATA	Mycobacteroides abscessus subsp. abscessus
CCCTCCGGAGAGTTCCCCGGAAGGGCCGCAA	Mycobacteroides abscessus subsp. abscessus
CCGACCGCAAGTGCGTCGGCCCCCTCGGCCC	Mycobacteroides abscessus subsp. abscessus
ACGCACACGCCACCCGCGAGATTGCCGGCGC	Mycobacteroides abscessus subsp. abscessus
TCCGGCGAGGGTGCCGTGCCCCGTATGTCCC	Mycobacteroides abscessus subsp. bolletii
TTGCCGAGCGGGAGGCCGCCGAGCGCAAGGA	Mycobacteroides abscessus subsp. bolletii
CAGGTTTCGCAAGGACTACGAGAGCAAGTTC	Mycobacteroides abscessus subsp. bolletii
TACTTCGCCACCGAGCGCGGTCTGCGCGGCT	Mycobacteroides abscessus subsp. bolletii
GGATGCCGCCGTACTGCTGGCGCCCACCGGC	Mycobacteroides abscessus subsp. bolletii
ACATGTGACCTTCGCAGTGTCCGCGGCAGAA	Mycobacteroides abscessus subsp. bolletii
ATCCATGCGCGTCATGCCGGCACTCAGCTCA	Mycobacteroides abscessus subsp. bolletii
CCGACCTCGGGCGCACCCACCGCCCATGGTG	Mycobacteroides abscessus subsp. bolletii
CAGCGCCTCGTACACACGGACGAGTTCCGGG	Mycobacteroides abscessus subsp. bolletii
ATCAACAGCACCAACGCAAGTGACACCGCCA	Mycobacteroides abscessus subsp. bolletii
GGATGGCGATGCTGTGCCGGTTTTCTTCGGC	Mycobacteroides abscessus subsp. massiliense
CGATGCTGTGCCGGTTTTCTTCGGCGGTCCA	Mycobacteroides abscessus subsp. massiliense
TGCTGTGCCGGTTTTCTTCGGCGGTCCAGCG	Mycobacteroides abscessus subsp. massiliense
CTGTGCCGGTTTTCTTCGGCGGTCCAGCGGT	Mycobacteroides abscessus subsp. massiliense
CGCGGATGGCGATGCTGTGCCGGTTTTCTTC	Mycobacteroides abscessus subsp. massiliense
TCGCGGATGGCGATGCTGTGCCGGTTTTCTT	Mycobacteroides abscessus subsp. massiliense
TGTGCCGGTTTTCTTCGGCGGTCCAGCGGTT	Mycobacteroides abscessus subsp. massiliense
ATGCTGTGCCGGTTTTCTTCGGCGGTCCAGC	Mycobacteroides abscessus subsp. massiliense
ATGGCGATGCTGTGCCGGTTTTCTTCGGCGG	Mycobacteroides abscessus subsp. massiliense
GCGGATGGCGATGCTGTGCCGGTTTTCTTCG	Mycobacteroides abscessus subsp. massiliense
TCCACCGTGCCCGAGGTGCGCGCCGAGGTGC	Mycobacteroides chelonae
TTGGCCAGGTCGAGGTCCTGCACGAGACGCA	Mycobacteroides chelonae
TCCCGATCGATTCTGGGCCGGGTAGCCGATC	Mycobacteroides chelonae
GATAGCCAGGGCCGGCGCATAACCTCTTGGG	Mycobacteroides chelonae
GGGTTGAGCAGGCTGTCGTGATCGCCCGTGA	Mycobacteroides chelonae
CGTGGTCGGTCGGCCAGCAGGGCAGGAGCGA	Mycobacteroides chelonae
GCGATGTCGACGGCGTGCTGATCCCCGGCGG	Mycobacteroides chelonae
TTCTAGGGCAAACCATTTGCTTATACCGACC	Mycobacteroides chelonae
TGAACGCCAAGTCCGCTTTCCTGTTCCTCAA	Mycobacteroides chelonae
GGACTCGCCGCTCTGGCTCAGCAGGTCAGGT	Mycobacteroides chelonae
GATCCGACATCGAGCGACTCGCCATCCATCC	Mycobacteroides franklinii
CACGGCCGCCTGAACGAGCTGCAGGGTGCCG	Mycobacteroides franklinii
CAGGGGGTCGTCGGGTACGGCCGCCATCCGC	Mycobacteroides franklinii
CCTTCGTCGTGGCCGTCATGGGGATGCTGGT	Mycobacteroides franklinii
GAGTCGCGGCCTCATGGGCTCTGGCCACGCA	Mycobacteroides franklinii
ATGTGATCACGCATGTACACGAGACGCGGAA	Mycobacteroides franklinii
CGGTTGTTCACGCGCCGACGACCGCCAACAG	Mycobacteroides franklinii
CCCACCGAGGCCGCCGGTGATGACGTACGCC	Mycobacteroides franklinii
GACATTCGGAAGCCCGGACGGGTCAAGGGGA	Mycobacteroides franklinii
TGAAAGTCGGTGAGCCCGATGTTGTTTCCGA	Mycobacteroides franklinii
CCAGGCCTCTTAGCGTGAAGACACAAAGGCC	Mycobacteroides immunogenum
GTTCCGTCGGGCTGCCGGTAGGCCTTGAGTC	Mycobacteroides immunogenum
CGTTCCAGAGCCCGGATTCGCATGCTTGCGG	Mycobacteroides immunogenum
ACGGATTTCCGCCAAAGGTGGAGCCGTGTTC	Mycobacteroides immunogenum
CCGTGCAATGGTTGGTCGACCACGAAGGCGC	Mycobacteroides immunogenum
CACCGATACGAATGTGACGCCGGCGTCGCTG	Mycobacteroides immunogenum
ACCGGATGGTCAGGACCCAGAATAACGGGCT	Mycobacteroides immunogenum
GCGGCAGCCGACGTCCCGGATGGGCGTTGCT	Mycobacteroides immunogenum
CGGGGGCCGGCCTCCAACGCGCAGCTGGACA	Mycobacteroides immunogenum
AGATCAGATAGGCGGCATTGTCCGGAGACAA	Mycobacteroides immunogenum
GGGCCTGGGATTCGTTCTTGGCAGCGGGCAC	Mycobacteroides salmoniphilum
GTACGCGGCCATGAAGGCCACGCTCATGTCC	Mycobacteroides salmoniphilum
CCGCAAGCACATGAACTCCGGCATCCCGAGC	Mycobacteroides salmoniphilum
GCACCGAGGCCACCTCCACCGCACTCAGGCC	Mycobacteroides salmoniphilum
CGAGTGCGCGGGGAATTCTCTGTGCCGTTCC	Mycobacteroides salmoniphilum
TGCCGAACCCGACTCCGTACAACAGGAACCA	Mycobacteroides salmoniphilum
CAAGGCAATCCTGTCGTTCTTGACCACCTCT	Mycobacteroides salmoniphilum
GCCACATGCTCACCGGCCACGGGTACCGGTA	Mycobacteroides salmoniphilum
TTCGAGCAGAGTGCGCCGGAAAGGTTCTACG	Mycobacteroides salmoniphilum
GTTGAGCCGGAAACCGCTGGGGGTGCGGGTG	Mycobacteroides salmoniphilum
GCACAGCGGAGCCAGCTCCAGATCCGGAACA	Mycobacteroides saopaulense
CCGAGGAGGCGCTGGAGGGGCTGCGCCAGAA	Mycobacteroides saopaulense
TCGTCAGAACGCGTCGAAAGTACCTGATCAG	Mycobacteroides saopaulense
CCGTCTGCCCGGTATCTCGGCGTGATGGCGG	Mycobacteroides saopaulense
AGCAGGCAGGCAACGAAGTACGCGTAGCCCA	Mycobacteroides saopaulense
AGATTCTTGCCGGATTCTGCGATGTGGCATT	Mycobacteroides saopaulense
ATCACGCGGCCGATGATCTGCGCACCGCGAG	Mycobacteroides saopaulense
GTACACGCTCGTTTGCAGACGTCCGGCGGCC	Mycobacteroides saopaulense
AGATCCGGGCCGGTGACATCTTGAAGCAATC	Mycobacteroides saopaulense
TGAGTCCCTCGGGGTGGCGTAGCAACAATGC	Mycobacteroides saopaulense
GCCACCGTGCGGCAGCTGATCACCGACCTGG	Mycolicibacillus koreensis
GGCAGCACATGGCGGCGGTAGTCGGCCAGCG	Mycolicibacillus koreensis
TGGTGCGTGGTGAGCAGACGCAGACTCGCCG	Mycolicibacillus koreensis
TGGCCGGCCTCGCGGCGGTCACGGAAACCGC	Mycolicibacillus koreensis
CGCATCTCGGCGCGCTGCTCATCGCTCATCA	Mycolicibacillus koreensis
GTGCCGCGGACTCGGCCGGCGGTGGAGGTGC	Mycolicibacillus koreensis
CCCGCCGCACCCGCGCACCGTCGGGCTGACC	Mycolicibacillus koreensis
GTCTCAGCGTCGAAATGCAGATCCATCAGGT	Mycolicibacillus koreensis
GAGCATCTCCCCGGTGCGGTAGTCGACGGTC	Mycolicibacillus koreensis
CCGGGCCGCACCGACCAGGGCCAGGGCCGCC	Mycolicibacillus koreensis
CCTCGACGGCCCCGGCGTCGAGGTGCGGCCC	Mycolicibacter algericus
GGTTGATCATGTCCCCGGCCTCGGGCGTCAC	Mycolicibacter algericus
GCACTGCTCCGGGCTGGTCGTCGGCGCTGTC	Mycolicibacter algericus
GATCTAAATAACGCTCCACTTTCAGAAACCT	Mycolicibacter algericus
GCCGGCGTCCCGGACGGTCTTTCTCAGGTGC	Mycolicibacter algericus
CGACGCCGGTGCGGTCATGGTGCCTCGGCTT	Mycolicibacter algericus
ACAGTGTGAACGGAACCCGTAGGCGCACCAG	Mycolicibacter algericus
TCCTCGAATCTGTCTGAGCCCCGCTCGCATC	Mycolicibacter algericus
GCCGAGACCGGAGCCCCTGCGGATCAACCCG	Mycolicibacter algericus
TTCTCTGCTTGACTGCTGCCGTGCAGGGCTC	Mycolicibacter algericus
AGCTACCGGATCGATCCGGGCCGCCCGGAGC	Mycolicibacter arupensis
GGCCAACGGCCCGCGTTCTCGCCGCACAACA	Mycolicibacter arupensis
CGCCGGGGTGACCGCGCTGATCTTGGCCCTG	Mycolicibacter arupensis
CACCCGCGCGCAGGCGCTGTTGGTCGGTGCC	Mycolicibacter arupensis
CCTAAACGACTCGGGTTCCGGGGGTGCCCTC	Mycolicibacter arupensis
TTTGGGTTCGCGGCTGGCGATGCTGCCGCCC	Mycolicibacter arupensis
CGATCGCCTTGCCGGGCAGCGATTGACGGAT	Mycolicibacter arupensis
TGACCGGCCGCCGTCGGGGTCTCAAGACGGC	Mycolicibacter arupensis
AGGTCACCGAAGCCGGTGTAGGTGCCGTCGC	Mycolicibacter arupensis
TTCCCGAGACCAACTCCCTGACCTACCGCGG	Mycolicibacter arupensis
CCGCGCCTTCAAAGAGCGCAGGTCACCGGCG	Mycolicibacter heraklionensis
CAGCATCGAGTTGCCCGCGAACATGCCCCGC	Mycolicibacter heraklionensis
CCTGCCCGATCCCGGTCAGCGGTACATGTCG	Mycolicibacter heraklionensis
TCGGGGGTGGTTTTTAGCGTCGGGGTATGGC	Mycolicibacter heraklionensis
ACCGGCTGCCGATCGACATCGAGGTGCTCCC	Mycolicibacter heraklionensis
GCGCCTTCAAAGAGCGCAGGTCACCGGCGTG	Mycolicibacter heraklionensis
CAGCTCCGGGTTGCGATAGGAGTTGCACGAC	Mycolicibacter heraklionensis
CGGGGGTGGTTTTTAGCGTCGGGGTATGGCA	Mycolicibacter heraklionensis
AGCAGCTCCGGGTTGCGATAGGAGTTGCACG	Mycolicibacter heraklionensis
TCGGGGGTGGTTTTTAGCGTCGGGGTATGGC	Mycolicibacter heraklionensis
GGCCGCACCGCGCTGCGCCAGCAGTTGCGCG	Mycolicibacter hiberniae
CGCTGAGTGGTTTCGCCGAACGTGCATTCAC	Mycolicibacter hiberniae
TTCTTCGGCCGCGGTGTCGAGTTCGTGCAGG	Mycolicibacter hiberniae
TCGGTGGAGGACGCCGAAAGCTTGGTTTCGG	Mycolicibacter hiberniae
GCGCGGCAACGGCACCGCCGGGCGGAATCGC	Mycolicibacter hiberniae
TATTCCGATCCTCGGCGTGCGCGACACGCCG	Mycolicibacter hiberniae
GCGATCAGGAGCAGGGCGGGAATCACCGAAA	Mycolicibacter hiberniae
GGCTTATCACTGCTGAAGGCGAACGCCTTCG	Mycolicibacter hiberniae
GGCGACGTGCTGGAGACCGCCGACATCGATG	Mycolicibacter hiberniae
CGGTTTCGATGGCGCGCGCCACGTCGCCGGA	Mycolicibacter hiberniae
CCAGTACCCGTCATAAGCGCTCGAGCCCCGC	Mycolicibacterium acapulense
GTGGCCGAGGTGCTGGCTCAGGTGCGTGCCC	Mycolicibacterium acapulense
CCTCGGCCGTCGGCGGCCCGAACACTGACGG	Mycolicibacterium acapulense
CGACTTGCGCGAGGATTGGCCGCGGGCCCTG	Mycolicibacterium acapulense
GGGAAGGTCAACCTGCTGATGGGGGGCCAGC	Mycolicibacterium acapulense
GTGTCTGCAGCCCAGCTCGGTCAGGATCGGC	Mycolicibacterium acapulense
GGCTTCGGCAGCACGCCAGTGAAATCTCCGG	Mycolicibacterium acapulense
GGGCACGCGACGTTCCTGAGGTCGGACGTGC	Mycolicibacterium acapulense
CGCCGAACCTCGATCAGCCACTTCGGATCGT	Mycolicibacterium acapulense
TTCCGCACTGCGGTCAACGCCCGAGCGGGAG	Mycolicibacterium acapulense
CGGCGATCATCTTCGTCCAGCGCCCGCCTCG	Mycolicibacterium agri
CGCTCTATCTCGGCGTGACCACCAAGCTGGG	Mycolicibacterium agri
AGGCCCGCGTGGCCGTTCGCCGTCGCCACCC	Mycolicibacterium agri
GAATCGTTCTACGAGACCGACGCCAACGGCA	Mycolicibacterium agri
GTCGGGCCGTAGGCATTGATCATCGTCCGGC	Mycolicibacterium agri
GCGGGCACAAGTGTCTGCTCGCCGAGGAAAG	Mycolicibacterium agri
GAGTTTCCCAGGGGCGCTGCACATGCCGGTC	Mycolicibacterium agri
GGGCGTGCTGTTGGGCCACGCTCAGGAGCAG	Mycolicibacterium agri
CGGGGGCGGCGTGGTGGTGTGCCCGTCGGGC	Mycolicibacterium agri
GCCCACGTTGCCGACCATGAGCTGACGGGTT	Mycolicibacterium agri
AGGCGCGCCTTGCCGGCGAGGATCGCGAGAC	Mycolicibacterium aichiense
CAACCGGGCCGATTCGGTTGCCAGATTCTCG	Mycolicibacterium aichiense
CTTCCGCGCAAGTTCAAGACCGCCGTCAGCG	Mycolicibacterium aichiense
GTCCGGGACGGTCTCTTGCGGGCCGCCCGGC	Mycolicibacterium aichiense
TCGACGCCCCGGGCGATTCCACTGTGCCCGA	Mycolicibacterium aichiense
CCGGATTCGGTCGCGGGCATGACGTCGAGGA	Mycolicibacterium aichiense
CCGGGGCCCCTGCGTGCCGAAGTCGGTCACC	Mycolicibacterium aichiense
CACGTAGGGGTGCCCGTCGTTCGGCTGAAGC	Mycolicibacterium aichiense
CTCCAGCGAGCGCGGCCCGGCGATCGCACCG	Mycolicibacterium aichiense
TCGTCGTCCAGTGCTCACCAGACTCGGCCTT	Mycolicibacterium aichiense
GACATGCCCGCACAGTGACCGCGGCCGAACT	Mycolicibacterium aubagnense
CGTCAACACCAGCAGCAGCACCGCGCAAACC	Mycolicibacterium aubagnense
TTGCGGAGGCCGTAGCCCTGGTGCGGGATCT	Mycolicibacterium aubagnense
CGGCGGAGGGTGCCAAGCAAGCCGCGATCCT	Mycolicibacterium aubagnense
GCGGAATTCGATGACGGCTGCCAGGACCACC	Mycolicibacterium aubagnense
CCCTCGGAGTAGCCGTCGATGTCGCCGCGGA	Mycolicibacterium aubagnense
GGGTTTGGCGTAAACCGCGTCGCCAGGGGCA	Mycolicibacterium aubagnense
GCGGATGACCTCGAGGTGATAGATCAAGAAG	Mycolicibacterium aubagnense
CTGCCCGAATTTGGCGGTGTCGGCGGCGATC	Mycolicibacterium aubagnense
AACATCGCTTACGCCATCGGCATCCTGGGCG	Mycolicibacterium aubagnense
CATCGACGTCGGTGTAGACCAGCCCGGCAGG	Mycolicibacterium aurum
CATCACCCCGATGGTGTCGCATCTGCGCAGC	Mycolicibacterium aurum
GTGGCCATCCTGGTCAGCCTGGCGGTGTTCG	Mycolicibacterium aurum
TCGGGTGCGTGCGGTTCAACGACGCCGACGA	Mycolicibacterium aurum
AGATCGGTGTCACCCGCCAGCTGATCGGCGA	Mycolicibacterium aurum
CTGTTCGCCACCAAATGCATCGACGGCCTGG	Mycolicibacterium aurum
CACGGTGTTGCCGCCGGCGATGGTCTTCATC	Mycolicibacterium aurum
GGCCTGCAGGCGCACCGTCCCGACCTGCTCG	Mycolicibacterium aurum
GCCGACACCGGGCGTGGAGTGCCGGACCTCG	Mycolicibacterium aurum
CGGTAGTTCGGGGTGCGGTACCACTCCGGGG	Mycolicibacterium aurum
CGGCCGAATGCCAGGCAACACATCGCCTTCG	Mycolicibacterium austroafricanum
GCTGTTCGCGGCGGGGCTGGGCGGGCGGCTC	Mycolicibacterium austroafricanum
ACCTCCCCGGGCGTGCCGGGGCCCGCCTCGG	Mycolicibacterium austroafricanum
TGACAGTGTCGGCGTCCAAGCCCACCACCGT	Mycolicibacterium austroafricanum
GGAAGCGGAAGCCGACGTCGACGAGTTCGAG	Mycolicibacterium austroafricanum
GGTGCTGCCACAGGAATGGAGGGTTCACGCC	Mycolicibacterium austroafricanum
TCCGAGGGCGCATGCCCGACGTGCAACGGTG	Mycolicibacterium austroafricanum
TCGGCGTGGACGGCAGCCTCGAGCGCTTCAT	Mycolicibacterium austroafricanum
TTCGGGCACGGGATCGGTCGCGATCATCGAG	Mycolicibacterium austroafricanum
CTTCCCGATCGTGCACGAATGTTGCGCCGCC	Mycolicibacterium austroafricanum
CAGTCGGTGGTGGACACCGCGGTCGCGCGCT	Mycolicibacterium boenickei
CCGCACCTTGTCGGCGGTGGCCTGTCCGACG	Mycolicibacterium boenickei
CGGTGTCATACACACGCAGGTTGGTCACCTT	Mycolicibacterium boenickei
CAATGGGCACCGGAGATCTGTTGGGTCGCGT	Mycolicibacterium boenickei
AGGAGATCTGGGAGCACGGTGCTGCATGGGT	Mycolicibacterium boenickei
GGACAGCACCCGCCGATCCTGGGTCACCTCG	Mycolicibacterium boenickei
CGCCACGGCGGCGAACACCGCATCTACCGAT	Mycolicibacterium boenickei
GGAGATCGTGGCGGCCACCCGCGACCGGTAC	Mycolicibacterium boenickei
CCGGGCGCCGGGCCGGAACCGCAATGGATGA	Mycolicibacterium boenickei
CCAGGAGTACGTCCTGGACGAGGTCGTAGTC	Mycolicibacterium boenickei
GTTGTTGTTGCCGGAGTTGTTGTTGCCCCCG	Mycolicibacterium brumae
CTGGAGCAGTTCGCCACCCGGTTGGCCGAGA	Mycolicibacterium brumae
GCGGCCGCCTCCATCGCCTCCGGCAGCGCCG	Mycolicibacterium brumae
TACACGGTGTCCCTTTCGGTGACGCGGTCGG	Mycolicibacterium brumae
GCGCCGGGCCTGATCAGCGATCCAAACGGGG	Mycolicibacterium brumae
CCGACGACAACACCGACCGGACCGTGGACCT	Mycolicibacterium brumae
GGTCCAGCGCGAGCAGCGAGTCGATGCCGAG	Mycolicibacterium brumae
TATCGACCGCAAGACCATCCGCAAGTATCTG	Mycolicibacterium brumae
GTTCACGCATGACAGGAGTGGTTTTGATGGC	Mycolicibacterium brumae
CGACCGGTGTTCTGGTAGCGCACGCTGGCCA	Mycolicibacterium brumae
TCGTGTGCTCGGCAATCGTGGCGAAGACGGC	Mycolicibacterium canariasense
ATGCCGCGAAGTTCGCGTTTCTGCTGGCCAC	Mycolicibacterium canariasense
AGATGGCCAGCGCCGGGGTGCGCACCGAAGC	Mycolicibacterium canariasense
CTGATACGACGCTCGGTCGTAGTGCCCGGCG	Mycolicibacterium canariasense
CCACCGTCGCCCGCTGATAAAGCACCGAGAA	Mycolicibacterium canariasense
CTATTGAAGCAGGTCACCGGCCGACGTGCGT	Mycolicibacterium canariasense
TCGACCCCCGCCGCCGCAACGTGTTCGAGGG	Mycolicibacterium canariasense
CACCGCCGTTCCGGAGGCGCGCCCGATCGAC	Mycolicibacterium canariasense
GTGATCACCGCGCCGGGTGGGTACTTCCCCG	Mycolicibacterium canariasense
TCGCGCATTCTTTGGCCCGTTTTGACCGCCG	Mycolicibacterium canariasense
GACCGCGGAGCGCAGCGCACCGAACTGGTCG	Mycolicibacterium celeriflavum
TCGCACCGACGTTGATCGGCACTCGAGGCTC	Mycolicibacterium celeriflavum
GCACCGTCGCGATGTTGTCGAGATCGACGTA	Mycolicibacterium celeriflavum
GACCGAGAAGGCCTAGTCCACCTGGTCCTCG	Mycolicibacterium celeriflavum
ATCACCGCCATCGCCGCGGCGAAAGGGACGT	Mycolicibacterium celeriflavum
CGATCGGATCCCGTTCTGCGGCAAGCTGGGT	Mycolicibacterium celeriflavum
CCGGACAGCGCGACCAGCAGCTCGGAGGGTC	Mycolicibacterium celeriflavum
GCGCAGACCTCGTCGATGTCCGGCTGCGCAC	Mycolicibacterium celeriflavum
GCCTCGGGCCGGTGACGATCCTGGTCAACGC	Mycolicibacterium celeriflavum
GCATCTTGTCGGGCAAGTGACCGGAGGTCGC	Mycolicibacterium celeriflavum
GTAGCAGTCCGCCCGAAAGAAGTCCGCCCGA	Mycolicibacterium chitae
CCGCAAGTGCCCCACATAACTCGCGCGCTCT	Mycolicibacterium chitae
CGACGAGGTCGAGGAGCAGGCGCGGAGCGCG	Mycolicibacterium chitae
CCGCCGTGGCGGTCTTACCGTCGATGTCGGT	Mycolicibacterium chitae
AGCAACAGCGTCAGCACACCGGAATCCTTGT	Mycolicibacterium chitae
GTCGTGACACGCGTGCAGTACTCATGTAAAT	Mycolicibacterium chitae
CCGGCTCGATCTGCTGGCTGACGTCGGCGGT	Mycolicibacterium chitae
CGCCGGTCTATAACCGTGGCGTGGTCGTGCA	Mycolicibacterium chitae
GCGTTGTTGCCGCACCTGTGGAAGACCACCC	Mycolicibacterium chitae
GATGGGGCGGTAGTGGGTGTCGCCGGGGCGC	Mycolicibacterium chitae
CACGGTCTCGGGTTTCAGCGAGAGTCGTTGG	Mycolicibacterium chlorophenolicum
AGCAGAACGGCCAATGACGTGAAGCCGTCGG	Mycolicibacterium chlorophenolicum
ACGTCTCCGAGCCCGCGCAGGTCGCGTCGGC	Mycolicibacterium chlorophenolicum
CCGTGGGTGATGGTGGCCGGCTTCCGCATCA	Mycolicibacterium chlorophenolicum
GGCATCCCCCTCGCCGCCGGAGTGCTCTACC	Mycolicibacterium chlorophenolicum
GCCATTCACGTGGCGATCCCATCTGGCGGCG	Mycolicibacterium chlorophenolicum
GTCACACGCGCGCAGCGGTGGGCGCAACGCC	Mycolicibacterium chlorophenolicum
GGTTCGACCTGGTGTTCGGTACCGCGGCTCT	Mycolicibacterium chlorophenolicum
AACGGCAGGCCCGGCGGGCGGGTGGGCTCGA	Mycolicibacterium chlorophenolicum
CGGACGCGACGTCCTGGTGCTGGAAGGCCGC	Mycolicibacterium chlorophenolicum
AAGGCCTATCCGCACACCGGGCACTACATCG	Mycolicibacterium chubuense
ATACACGTACCGATCTTCGACATCGACGGCG	Mycolicibacterium chubuense
CCTATCCGCACACCGGGCACTACATCGCCGC	Mycolicibacterium chubuense
CAGCTTCTGCCCCTCGGGGGTGTAGAGGAAG	Mycolicibacterium chubuense
ACACGGTCACCGTCGCGCCGTTCGCGATCGA	Mycolicibacterium chubuense
TCTGCCGGTGCTCTACGAGCTGGCCAGCGAG	Mycolicibacterium chubuense
CCGCGCTCGACACGGTCAACGACACGGTCCA	Mycolicibacterium chubuense
CGGCGACCTCGTTGCGGCGGCGGAACGGCAG	Mycolicibacterium chubuense
GCACCAGTTCCGCTACTACGTGCGCGACGCC	Mycolicibacterium chubuense
AGCCAATCGAGAGCAGCACCCAGCACGATCG	Mycolicibacterium chubuense
ACCCTCGCCGAGGCGGGTGTTCCACGGGAAC	Mycolicibacterium conceptionense
GAGCCCGAATGAGCCATGACACCGCGGATGC	Mycolicibacterium conceptionense
GGCAAGCACCCACGCTGGCTGAGATCACCCG	Mycolicibacterium conceptionense
GTGCTGACCGTGTTGTTGACCTGAGTGATGC	Mycolicibacterium conceptionense
CCGTCCGCGCCGGTCGACGCGGCCGATCAAC	Mycolicibacterium conceptionense
TGAGGTCGCCGGCGTCGATCTGTTTGACCGG	Mycolicibacterium conceptionense
AGGTGTTCCGTTCGCTGTCCGGCGACCCGTT	Mycolicibacterium conceptionense
TCGCCCTCGGGTGAGAACACCGTGGCCCGAA	Mycolicibacterium conceptionense
CCACCGAACTCACCCTGGTCTCGAACGTGAT	Mycolicibacterium conceptionense
ACGATCTGGGCGTTGCTGTCGCGCAGCGCGG	Mycolicibacterium conceptionense
CCGCGAGGTCCTCACGTCCACCGACGTCGGC	Mycolicibacterium confluentis
GGCTCAGCCCCGTGGGCATCGGCGGCAGGTT	Mycolicibacterium confluentis
CCAGGTGAACGAGCCGCTGACCACGGCGTTC	Mycolicibacterium confluentis
CTCATCTCCTCGGTGGACAACTCCCGGTGCC	Mycolicibacterium confluentis
TGGGCGACGAGCCCGCAGGCCCCGCATCTCG	Mycolicibacterium confluentis
ACCTACTCGGCGTACTTCGACGATGCCGGCG	Mycolicibacterium confluentis
GCGACATCAGGCTCGACGAACTGTTCTACAC	Mycolicibacterium confluentis
CGCGGCGCTTCTTCGCGATCCGGATCAGCTC	Mycolicibacterium confluentis
GCTCGCACAACTGAGCCTGCTGGCACCGGGC	Mycolicibacterium confluentis
GGTCGTCGGCGCTGCGCACGTCGCGCGTGAC	Mycolicibacterium confluentis
GGCTACATGCCCGAACTCAACGGCGCGCTCA	Mycolicibacterium cosmeticum
CCGTCCTGCACATGCGCGGTGACGCCGACCC	Mycolicibacterium cosmeticum
GGCTCGGGATCTTCTTCCTGGCCTACGGCCC	Mycolicibacterium cosmeticum
CAACAGCACGTAGATGGAGGTGAACCAGAAG	Mycolicibacterium cosmeticum
GCGTCCTAAATGACGAATCCTCCGTCGATGT	Mycolicibacterium cosmeticum
CGTGGTGGCGCCCGCCGCGACGGCCTCGCTG	Mycolicibacterium cosmeticum
GGTTCGGGCTCTTGCCGCCGCACTCCAGCCA	Mycolicibacterium cosmeticum
GGTGCGGCCCAGCTTGCACGCGACGTCGCCG	Mycolicibacterium cosmeticum
TGCTGCACCGACGCCCGCTCCAGATCGAGCA	Mycolicibacterium cosmeticum
CGTGCTGACCGGATTCACCGTCTCCCAGGCG	Mycolicibacterium cosmeticum
GTGATGCGGCCGGACTCCACGTCGACGTTGT	Mycolicibacterium diernhoferi
TAGTGGAACTCGCCAACGCCGTGGACGACCA	Mycolicibacterium diernhoferi
CCTGCACAACACGGCATCCAAGTGGATCGCC	Mycolicibacterium diernhoferi
GGGTTCGGGGTCGGACCGGACACTCGGGCGC	Mycolicibacterium diernhoferi
CGCGCGCTGCGCACCGCGCACGCCATCGAGG	Mycolicibacterium diernhoferi
GGTGTTCGACGAGGATGCGCTGCGGTGGACG	Mycolicibacterium diernhoferi
AGACCGACCACCGTCGCCCCGTCACGCACCG	Mycolicibacterium diernhoferi
GAATACGACAGCCTGGCCCAGCTGAACCCGC	Mycolicibacterium diernhoferi
GTGGCCTCGTTGCAGATCACCAGCGAGGTCT	Mycolicibacterium diernhoferi
GGTCTGGGGGAATGGGTGCGGCTGGATCACC	Mycolicibacterium diernhoferi
TCTCCTCCGAATCCCAACCGCGTCGCCGGTC	Mycolicibacterium duvalii
TCTGCCCGAACTGATTCGCACCGCGCTCACC	Mycolicibacterium duvalii
GACCGACCACCGTCGCCTCCAAAGCGGCCAG	Mycolicibacterium duvalii
CGCGCCGCTGGCGCAGTGCCGCACCGCTGTG	Mycolicibacterium duvalii
GCGGGCAGAGCGGCGACGTGCGCGGCGTGGT	Mycolicibacterium duvalii
ACGCGCCGACGATCAGAACGAATGCGGCGAT	Mycolicibacterium duvalii
CGTCGCGGCGAGGGCGGCGTGCGGCCCATGC	Mycolicibacterium duvalii
CACTTCAACAAGTTCAGCGGCGCTCAGGGAG	Mycolicibacterium duvalii
GGGTAGGGAACCTGGCACTCCAGTTCGTCGT	Mycolicibacterium duvalii
AGCGCGCCACGAGTATCTGCGCCAGGTGCCC	Mycolicibacterium duvalii
CGCCTGGGTCAACCGCGACCTCGCCCCGCAC	Mycolicibacterium elephantis
CCGGTCGACGTCGTCTACGCGGGGTCGTTCG	Mycolicibacterium elephantis
CGCATCGAAGGTGGTACTCGATCGCCCAGTC	Mycolicibacterium elephantis
TCCAGGGTGAACTGTGCGGCCCCGATCGTCT	Mycolicibacterium elephantis
CGTCGACTCCGGGGTGAAGGGCAGGCACAGC	Mycolicibacterium elephantis
CGGGTGACCCTGCACGAGGGGCGCAAACGGA	Mycolicibacterium elephantis
AAGCCGATGCCGCTGCTTGCGCCCGTCACGA	Mycolicibacterium elephantis
CCGGCGACCCCTCACCTGACACCGGGATCGA	Mycolicibacterium elephantis
GGACGGCGGCTTCGAGGTCGTGGGACAGGTT	Mycolicibacterium elephantis
GGGCGGTCTGCGTTTCCGCCCGCCGACGGGG	Mycolicibacterium elephantis
GACCTCGGCGGTGAAGGCCAGCTGCTCGCCG	Mycolicibacterium fallax
CGATCCGCAAGGCGGGCAGCAAGAAGGGGCC	Mycolicibacterium fallax
GCGGGGTCGGCGGCGACGACGGTGTTGGTCA	Mycolicibacterium fallax
CATCCGGCTACGCGGACACCTTCGCCGCGTT	Mycolicibacterium fallax
CGGCCGCGGGGGTGCCGTCGTACTTCGTCAC	Mycolicibacterium fallax
TGGGGCAGCGGAGCCGCCGCCGTTGCCGTTG	Mycolicibacterium fallax
GGTCTTGCCGACCCCGGTCGGGCCGAGGAAC	Mycolicibacterium fallax
CCCCGGCGGCCAGCGCCGCGCACACCTGCGC	Mycolicibacterium fallax
AGGAGTGATCCCGAAACCGGATCAAGGTCGC	Mycolicibacterium fallax
CCACGCCGAGCAACGCGCTGTCGGTGCGGAC	Mycolicibacterium fallax
CCCCACCGCCGCCGCGTAACGCCCAGTACAG	Mycolicibacterium fluoranthenivorans
TGCGGCGGATCGCCTTGGAGACCGCGCGGAC	Mycolicibacterium fluoranthenivorans
TCGGGGAGGGCGGCGACGCCCATGTTGACCT	Mycolicibacterium fluoranthenivorans
GGGCCGCCGACCCCAGCTTCGCCTGCGTGGT	Mycolicibacterium fluoranthenivorans
GGAATCGTCTATGTGCCCGAAGGGGATTCGT	Mycolicibacterium fluoranthenivorans
GCCACCGGCATCCTCAACCTGTGGATGCACT	Mycolicibacterium fluoranthenivorans
CGACCAGTTCCTGACGATTGCGAAACTGCGG	Mycolicibacterium fluoranthenivorans
CGGTGCCACAGCGCACCATCGACGAATGCGA	Mycolicibacterium fluoranthenivorans
TTGTTACCCCACTTTTGTTGGGGTGTGTGTA	Mycolicibacterium fluoranthenivorans
CGTCACCGCCACCCCGTGCTCGGCCAGCCAG	Mycolicibacterium fluoranthenivorans
GCCGACCGGGCCCGAGCCTGGGTCATCGTGC	Mycolicibacterium fortuitum
AAGGGGACCTGCGCGGTGGAACTCGACCTCG	Mycolicibacterium fortuitum
TGCCGGCACCGTAGGAGCCGCCGATCACCAC	Mycolicibacterium fortuitum
GTGCAGTTGTCCGGCCAGCGGATGGTGCCGG	Mycolicibacterium fortuitum
CAGAACTGCGCCCGCCCTGCATCCGACGCGC	Mycolicibacterium fortuitum
GAAGGTCACTGACCGGAAGGCCCCATGTGGC	Mycolicibacterium fortuitum
CAAGTAGCGGCCCAAAATTCTCCGCGATCAG	Mycolicibacterium fortuitum
GCGTCCGGCGACGGTCTCCTCGCACACGATG	Mycolicibacterium fortuitum
GTCCAGGGTGCTGGGCGGCATGTCCAGCTCG	Mycolicibacterium fortuitum
GCCCACGCCCGCCTCACTTCGTCGGTCATGG	Mycolicibacterium fortuitum
TGGTCACGGCCAAGCGCGGCCACAGCGCCGA	Mycolicibacterium gilvum
CCGTCGGAGAGGTTGACCGCCACCACGCGCC	Mycolicibacterium gilvum
CTGCATACGCGCGGCCGCCGCCCCGAGGCAG	Mycolicibacterium gilvum
CCCGCGGTGCGGTAGGAAAGAGGGATGCCGC	Mycolicibacterium gilvum
AACTTCCAGAACCTCTTCCAGGCGTTCGCGA	Mycolicibacterium gilvum
CTCGCGGTCGTGATCCGCGCGACGTGGGCGG	Mycolicibacterium gilvum
GGACCTGACGGACCGGTTGCGTGCTCTCGGC	Mycolicibacterium gilvum
CGGGCACGTGCGTCGGTGGGGTCGGGGAGTC	Mycolicibacterium gilvum
GTCTCTTTGGTGTTCGTCTTGGTAGCCATTT	Mycolicibacterium gilvum
AATCTCGTTGTCTACTACCACGTCTCACGAC	Mycolicibacterium gilvum
ACACGATGTGCGGGCTGTTCGACGCGGTGCG	Mycolicibacterium goodii
CATGGCACCGCGGATCCGCAACCTCGCCGAG	Mycolicibacterium goodii
CGGCGATGATCTCGAAGAACGCGAACACCAG	Mycolicibacterium goodii
CGCCCGGCAGCGACGCCACCCCGACGGCCGT	Mycolicibacterium goodii
TGACCCCGCTGCGCGGCAACGAGTTGTGGCA	Mycolicibacterium goodii
TACGGTGTCGAGCCCAACCGCGCGATGCTCG	Mycolicibacterium goodii
ACGAACTGGATGATCACCGACCCGCCGGGCG	Mycolicibacterium goodii
TCGATCACGAGGCCCTTGTCGAGGATCAGTT	Mycolicibacterium goodii
GCCGCAACCGCGCGCTCGCGTCGACGCCGCT	Mycolicibacterium goodii
CTTGAGGTCCTTGATCCAGGCCAGCACGACG	Mycolicibacterium goodii
TGCCTTCACGACGTCTTCGAGCGTGTAGGCG	Mycolicibacterium hassiacum
ACCTGCTGTTGGCGCAGGCGCTGTTGCGGAC	Mycolicibacterium hassiacum
ACGGCCCGCTGTTCAAGGGCAAGCGGGTGGC	Mycolicibacterium hassiacum
CAAGTGGTACTGCTCGCAGGCTGCCACCGAT	Mycolicibacterium hassiacum
CTCCTCGGGGATCGTGAAGTCGATCATGGTG	Mycolicibacterium hassiacum
GGTCGCGATCGAGTGGCCCTACTCGGCGAAC	Mycolicibacterium hassiacum
CCCGACCGACCCGGCCGGCACCTGGGTGCGC	Mycolicibacterium hassiacum
GCAACCACGAGTTCAACGCACTGGCCTACGC	Mycolicibacterium hassiacum
ATCGTCGACGAGCAGGGCACCACGACCGCCA	Mycolicibacterium hassiacum
GGCGCTGGGCGACCAACCGATGGGCGTCGCC	Mycolicibacterium hassiacum
GCATGACGCTGTACATCAGCGCGTCGGTTGC	Mycolicibacterium hippocampi
CCGGATGGAAACCGACGATCGGATCGTGATC	Mycolicibacterium hippocampi
ACCGTTGACGACGAAGTCGTCCCACCACTGC	Mycolicibacterium hippocampi
TCAACTACGACGGAGAAGCCAAGCGGCGCAC	Mycolicibacterium hippocampi
TCTTCACCGCGGTGGTGTCCGGCTACTGGAC	Mycolicibacterium hippocampi
CTACTTCGATCAACGCATGGAACCTGCGCTG	Mycolicibacterium hippocampi
TCAGCGAGAGCGTGCTCACCGACACGATCTA	Mycolicibacterium hippocampi
GTCCACAGCACCTGCCCGGTGATGTACCCGG	Mycolicibacterium hippocampi
CCAAGTACGACAAGGCAATCGAGCTCGGGGT	Mycolicibacterium hippocampi
CTTCTCGGCCGCGATCTTGGCGACCTCCTTG	Mycolicibacterium hippocampi
TCAACATGAGTGAATCGGCGCCTCTCGTGGT	Mycolicibacterium hodleri
AGCCGTACTTCGGCGACGTGGCGGACATGAC	Mycolicibacterium hodleri
GTCTTGTCGCCGGTGGCGTCGAACACCGCGG	Mycolicibacterium hodleri
GTGCCTGGCGATCGCGTGGTCGGCGAGGCGG	Mycolicibacterium hodleri
ACGTACACCTCGACGACGTTGTCGGCGCCTT	Mycolicibacterium hodleri
GGCGTCGAAGAGGCCCGCAAGAGCTTCTTCC	Mycolicibacterium hodleri
CTGGAGATCATGTTGGCCCGCACCCAGCAGC	Mycolicibacterium hodleri
CGTGTGATGCAATCATCCCGTCCATGGTGGA	Mycolicibacterium hodleri
CGTGAAGCCCAATCGCACAGGTGCTGCGCTG	Mycolicibacterium hodleri
TCACCCGACCGATGGTGCCGTGCATCGTGTT	Mycolicibacterium hodleri
CCGCCGACTACGCGATCGTCGGTGGCCCCGG	Mycolicibacterium insubricum
ATTGGTTCCGGTGACGATGCGACCGTCGTCA	Mycolicibacterium insubricum
TCGGTAGCCCGGCCACAATGGTTCGCTCACC	Mycolicibacterium insubricum
CCGACCACCGCCGAGGCATCCAGCGCCACAC	Mycolicibacterium insubricum
GGTTGCGGATACATCTGCTGCGCCATGCCCG	Mycolicibacterium insubricum
CTGCAGCAGGGTCTTCTCGACCCGTTCGGCG	Mycolicibacterium insubricum
CCAGGTGGCCACCTGGTCTTCCGGGCGGGCC	Mycolicibacterium insubricum
CGCTGGTGCTGCGCAACGATCTTGCGGTGCC	Mycolicibacterium insubricum
GTTCTTCGGTGACGGCGATGTAGTTGCGCAC	Mycolicibacterium insubricum
ACGAGACCGTCTTCGGCTTGCTGCTCAGCGT	Mycolicibacterium insubricum
CTCGTCCAGATCGGTCTGACCGCCGTCGTCG	Mycolicibacterium iranicum
ATGGTGGGCGATGAACACGCGCCGCGAGCTG	Mycolicibacterium iranicum
AGATCCTGAAGAATCCCGCGCTGGAGGCGGT	Mycolicibacterium iranicum
CTCGTCGAGCCAGATCTGCTGCTGGATCGGC	Mycolicibacterium iranicum
GGCAAACGCGATCGCGTAGTTCCAGACGTTC	Mycolicibacterium iranicum
CCCACATGCTTTACTGCAACCGCTACAACTG	Mycolicibacterium iranicum
CCGCGTTCGCCCATCTCGTCGACGACGGCGG	Mycolicibacterium iranicum
AGGCCGTGGTGTGGGCCGTCGCGTTCGACCC	Mycolicibacterium iranicum
CGGTGGCCACCCGCGCGACGTTGCCGACCTT	Mycolicibacterium iranicum
GTGTGAGCTCGACGGGCCGATGCCGATCGAG	Mycolicibacterium iranicum
AGATCGACTAACGGCACCGGATGAGCGCGTC	Mycolicibacterium litorale
CCGCAGTGCTGTCGATAGCCTTCCCCAGGGC	Mycolicibacterium litorale
GACGGCCTCTTCGAGTTCGGCGCCGATCTCG	Mycolicibacterium litorale
ACCGGACGCCGCAAGATCGTCTCGATCATCA	Mycolicibacterium litorale
GCCGCCGTCGACGCCCACGTCGCCGACTTCG	Mycolicibacterium litorale
CACTCATGGACGTCCCGTCGGTGATCTGACT	Mycolicibacterium litorale
GCCGCCGAACATGCTGATGCTGCCGAGCGCC	Mycolicibacterium litorale
GCGGACGGCAAGCTGCTCGACAACGCGCTGA	Mycolicibacterium litorale
GCCGGCTGTCGAACCGGACCACGCGATCGAA	Mycolicibacterium litorale
ACAACGGCGGTGACGAGAACTGGCACGTCTA	Mycolicibacterium litorale
AGTCGTTACCGGCGATGTGCTCGGTGACGAT	Mycolicibacterium llatzerense
GCGTCGACGACCCGGGCATCGCCGGTGAGGA	Mycolicibacterium llatzerense
GCGCATCCCGCGTCTCCTCCGCCAGCTCGCC	Mycolicibacterium llatzerense
ATCTCAACGGCGGCGCGGTGATCATGGCCGA	Mycolicibacterium llatzerense
AGTTGTAGCCGGCGGGCCACCTTCGGGGAGC	Mycolicibacterium llatzerense
TTCCGGTTGGATGTCGACGCGCTGCGCTCAC	Mycolicibacterium llatzerense
CAGCAGCGGCGGCGGCAGCAGCAGCAGCAGC	Mycolicibacterium llatzerense
GGTGGCCAATTGTCCAGAGGCTGTATCGACG	Mycolicibacterium llatzerense
GCAGCGGCGAAAGCCGGTACGCCGGGGACGA	Mycolicibacterium llatzerense
GATTCCCAGATCGGCGTGCCGTACAGCGACA	Mycolicibacterium llatzerense
GTCTGGGCAAGCTGTTGCAGGACGAGCCAGA	Mycolicibacterium mageritense
CTGATCTACGGCGAACTGCCGACCGCAGAGC	Mycolicibacterium mageritense
CCCAGCGCGTGCACCCATCCGGTCCAGTCGA	Mycolicibacterium mageritense
ATCGATGGGTAAACGTTCCGCGGGTCGCGAC	Mycolicibacterium mageritense
CCGCGCTACTGCCCGAGCGCGCGATCATTTC	Mycolicibacterium mageritense
GGCATCCAGGCCGGTGGCGGCGTGATGACCT	Mycolicibacterium mageritense
CTGGCGGCGCACGGACTCGCGATCCTCGGCG	Mycolicibacterium mageritense
AGACCGATATCGAGCATGGACGTCGGACGGC	Mycolicibacterium mageritense
CGTCCGATGGAGCGGATCAGGGACCGGCCGA	Mycolicibacterium mageritense
GCTCCGGCACCGCTGACCCCCGGGGGAATGT	Mycolicibacterium mageritense
GGCCGGCGCTTCCCGACGTCGAACTCGCTTC	Mycolicibacterium monacense
TGTCTCGGTGAGCCTGATGCTGCAGGTGAGC	Mycolicibacterium monacense
CAGCATCGCCTCGTCGAAGATCGCGGTTCCC	Mycolicibacterium monacense
CCCCCCCGGCGGCGATAAGTGCACTTATTGA	Mycolicibacterium monacense
AGGTGCTGATGATCGCCCGCGGCCTGTCACC	Mycolicibacterium monacense
GTCGGGGGCGTCGATCAGGTGCTCGACGAGT	Mycolicibacterium monacense
AGGAATCCGCTGAGCAGGGGTTCGGGCGTGG	Mycolicibacterium monacense
CCACGAAGGTGAGCTGCTGCGATTCTTCGAC	Mycolicibacterium monacense
CGTGGCGGCGTCGCGGTCGATGAAGAACAGC	Mycolicibacterium monacense
GGTTTCGCGGACTGGCGCAGCGTGTCGAACG	Mycolicibacterium monacense
GCGCGTTCGCCGACCCGGCGTCGCACTTCCA	Mycolicibacterium moriokaense
AGTCGGAGAAGTCGATGAACTTGCCCTTGTC	Mycolicibacterium moriokaense
TCGCCCGCGCCCTCGCCGTCCCAGTTGTCGA	Mycolicibacterium moriokaense
CATGCCGCCGGTGGCCAGCGCGACCAGGTGG	Mycolicibacterium moriokaense
AGGACAACGCCATCGTCACCGACGCCAGCCA	Mycolicibacterium moriokaense
ACGACGAGCGCGCCGACGTTGAGGAAGTTCT	Mycolicibacterium moriokaense
ACCGCGTCCTCGCCCGCGCCCTCGCCGTCCC	Mycolicibacterium moriokaense
GAGGACAACGCCATCGTCACCGACGCCAGCC	Mycolicibacterium moriokaense
CACCCACCGCCACGGATGACGCAGCGGAACG	Mycolicibacterium moriokaense
GCGAGGACAACGCCATCGTCACCGACGCCAG	Mycolicibacterium moriokaense
GACCCGATCTCGACGCTCGCCATCGAGGACC	Mycolicibacterium mucogenicum
ACCCGATCTCGACGCTCGCCATCGAGGACCT	Mycolicibacterium mucogenicum
GTAGTTAGCGCTGCTCTACCATCGGATCCGT	Mycolicibacterium neoaurum
ACGATGCGCAGACCGCGGGTGATGATCCACT	Mycolicibacterium neoaurum
CGAACGCCGGGTCGAGAACATCGATATCGAT	Mycolicibacterium neoaurum
CGGCGCGGCACCCAGGATCAGGTAGGCCTGC	Mycolicibacterium neoaurum
AACTGCAGATCGAAATCCGTGGGATGTTCGG	Mycolicibacterium neoaurum
ACTGTCCCCTCTTTACTCGATCACACCGGAC	Mycolicibacterium neoaurum
GTCCGGTCCACGTCGGCGACCCGCAGCGGCC	Mycolicibacterium neoaurum
AGGTCACCGCCTCCTACGACCCGCTGCTGGC	Mycolicibacterium neoaurum
CCGGCGCTCTACGAGGCCACCGGTGAGGTGG	Mycolicibacterium neoaurum
CCTTGATGACGGCGTGGACAGCCTCAGCGGG	Mycolicibacterium neoaurum
GCAGTGATCGGCGCCGCGCTCGGGCGGAGGC	Mycolicibacterium novocastrense
CGGTGCCGCCGACGGCGACGGTCGCGCCCTC	Mycolicibacterium novocastrense
GGTGGATCGCCTGCCCACGCGGTGGCACGAG	Mycolicibacterium novocastrense
GGGTGGCCACCGCGCCAACGGTCATGGCGTC	Mycolicibacterium novocastrense
CCACCACCTACGAGCAGGTCGACTCCGATCA	Mycolicibacterium novocastrense
ATTGCCGAGGACGACGAGGTCCGCGTCGCCG	Mycolicibacterium novocastrense
GAATGCCAACTGCTCGGCCTGTTTGGCGGCG	Mycolicibacterium novocastrense
GAACCATCGAGTAGATGGTCAGCTGCAATGT	Mycolicibacterium novocastrense
CGGTCGCGGTATGCGCGCCGTTGTCCAGCGC	Mycolicibacterium novocastrense
GCGCGCTGCGCACCACCGCGGCGGTACTCAC	Mycolicibacterium novocastrense
GTCGGAGAGGTCGATGTACTTGCCCACCAGC	Mycolicibacterium obuense
AGGTCGACGGTGTCGGCCAGGCGCTGCCAGA	Mycolicibacterium obuense
GGTCGACGGTGTCGGCCAGGCGCTGCCAGAC	Mycolicibacterium obuense
CGTCGGAGAGGTCGATGTACTTGCCCACCAG	Mycolicibacterium obuense
GCGCTGTCGGAGATCAATCCGACGCTGGAGG	Mycolicibacterium parafortuitum
CCGGTGGGCGATGTCGGCCGCCCGGCGCTGC	Mycolicibacterium parafortuitum
TCGGGCAGTCGCTCGGCGAGGCCGCGGCCGC	Mycolicibacterium parafortuitum
GTGGCGAGATCGGTCTGGCTGTACCGCTCTT	Mycolicibacterium parafortuitum
AAGATCACCACCCGGCAGAACGTCGCCAGAT	Mycolicibacterium parafortuitum
TGCTGGACTCCGGCGAGGTGGTGCGGTGCTC	Mycolicibacterium parafortuitum
GCAGCTGGCTCGAGATCCGCAGTGTCGCACG	Mycolicibacterium parafortuitum
GCCAGCGAGATCCAGCGCACGATCATCGCCG	Mycolicibacterium parafortuitum
ACGTGTTCCTGTTCTGCGGTCCATTATGACC	Mycolicibacterium parafortuitum
CGTCGGTGTCGGCACGCTTGTCCAGCGGATC	Mycolicibacterium parafortuitum
CAGAACGACGGCCGACCCGACCCCGAGCGCA	Mycolicibacterium peregrinum
CGCGGTCGTGGTGCCGGACACCGCGATCACC	Mycolicibacterium peregrinum
TCCAGATGACCGGGTAGGACGCCAGTGTCTG	Mycolicibacterium peregrinum
CAGCGGAATGCAGACCCGCATAGGCGCGGAT	Mycolicibacterium peregrinum
AATTCTCGCTGTGGTCGGCCTTCGCCTTTGC	Mycolicibacterium peregrinum
GTTCAGCTTGGCCGTCGTCGACAAGCTGAGC	Mycolicibacterium peregrinum
CGGCGGGCCGGCACAGCAGGTTGTACCGGCT	Mycolicibacterium peregrinum
ATCACGTAGCGCAGCGAGGACAGGTCGTAGC	Mycolicibacterium peregrinum
CATCGAGCAGTGCGGCGGTGGCGCGGCACCC	Mycolicibacterium peregrinum
CCCGATCGTCAGGGTCAGCTGTGAGGCCGGA	Mycolicibacterium peregrinum
CGCCGGCAGCCACCGCGTCGGAGAACGTCTG	Mycolicibacterium phlei
ATCCGGCGACCACGAGCACCTTGCCGAACGG	Mycolicibacterium phlei
CCTGTTCGGCCGTCACGTCGGCCGTGAGGTC	Mycolicibacterium phlei
CGTGGTGCGGATCAGCCAGCGGCTGCTCGGC	Mycolicibacterium phlei
TCAAGGTTCAGTTCCAGAAGGGCACCGGATC	Mycolicibacterium phlei
GTACACAACGGGTTTCGTCGGGTCGCCGCCG	Mycolicibacterium phlei
CACGCCGTCAACAGCGTGGTCAGCGCCCATC	Mycolicibacterium phlei
TCGGCCACCCAGGCCAGGTAGAACGCGAAGA	Mycolicibacterium phlei
TGGCCAGGGAGGCTGCGAACGGGCGCGACGT	Mycolicibacterium phlei
CGACCACGACGACGGCGCCGACGTAGAACGG	Mycolicibacterium phlei
GCCGCATGAGACTCCCCGGACCATGGATCGG	Mycolicibacterium phocaicum
CGAGCGAGAAGGCGATCCGCCCGGTTCCCGT	Mycolicibacterium phocaicum
CTTTCACCGCCCAGAACACGAACCCCGCCAG	Mycolicibacterium phocaicum
AAGCGTCCTATGACAGCGGTGGTCGCGCTGA	Mycolicibacterium phocaicum
CTGGCTGGCGCGGTCCGCGGAGGCGTCGGAC	Mycolicibacterium phocaicum
GCTGAAGTCTTCCGACCAGCCAACCTTGGCC	Mycolicibacterium phocaicum
ATCGACGTGACGAACACCGATACCGGGACGC	Mycolicibacterium phocaicum
GAACGTCGCCAACTTCATGAAGTACGGCGGT	Mycolicibacterium phocaicum
CGGCCGACGCCATCGAGGCTGCGCAACAGAC	Mycolicibacterium phocaicum
CGCCGAGGTCCGGGCGACGTTCGTCCTCGCG	Mycolicibacterium phocaicum
ACCGTGACTGTGGATCGCCAGGTTCCGGCCG	Mycolicibacterium porcinum
CTGGGCTTTCGGACCAAGGCGGTGCTGACCC	Mycolicibacterium porcinum
TTCCGAGAACCGTGGCGGCCGCGGCCGTCGC	Mycolicibacterium porcinum
GATGATGATCGGGACGGCCAGGCGCCGGATC	Mycolicibacterium porcinum
CGAGGACATGATCGGGCTGGCCGCGCCGTCT	Mycolicibacterium porcinum
ATTGCTCGGTGGCTCAGGGCAATTGGAATCC	Mycolicibacterium porcinum
TGGTGGCCCAGACGATGTTCCTGGCCAGCGA	Mycolicibacterium porcinum
TTGTCGCGATCGACTGCTTTGCCGGCCGATC	Mycolicibacterium porcinum
GTGCAGGGTGAAGATCTGCATGAAGCGTTGG	Mycolicibacterium porcinum
CGACGACCACGAAAGGCCCTGCGGCAGGGTC	Mycolicibacterium porcinum
ACAACGCGTGGATCGGCAAGATCACGTGCAA	Mycolicibacterium rhodesiae
GGAAGCTCTGCTGGGTGACCTCGGCGCAGAA	Mycolicibacterium rhodesiae
TACAACGCGTGGATCGGCAAGATCACGTGCA	Mycolicibacterium rhodesiae
CAACGCGTGGATCGGCAAGATCACGTGCAAG	Mycolicibacterium rhodesiae
AACGCGTGGATCGGCAAGATCACGTGCAAGC	Mycolicibacterium rhodesiae
ACGCGTGGATCGGCAAGATCACGTGCAAGCG	Mycolicibacterium rhodesiae
CTCGCCGCCGCGGCCGACGCGCTGGGGCGCC	Mycolicibacterium senegalense
TCGTAGACCCCAATCGTTTCTCGCCCGCCTA	Mycolicibacterium senegalense
CTGCTCGACGGCCTTCAGCAGCCGCATGGGC	Mycolicibacterium senegalense
TTCGCCCTGGATCACCGACAGCGGCTCGAAC	Mycolicibacterium senegalense
CGGCCGACGCGCTGGGGCGCCCGGATGCGGC	Mycolicibacterium senegalense
GCCGCGGCCGACGCGCTGGGGCGCCCGGATG	Mycolicibacterium senegalense
AACCTCGTAGACCCCAATCGTTTCTCGCCCG	Mycolicibacterium senegalense
CGCCGCAGCCGAATCCATTCGCGTAAACCTG	Mycolicibacterium senegalense
GCCGCCGCGGCCGACGCGCTGGGGCGCCCGG	Mycolicibacterium senegalense
GCACCTTGAACCTCGTAGACCCCAATCGTTT	Mycolicibacterium senegalense
GATTCATGCCGACACCCTACCCTCCGATTAA	Mycolicibacterium septicum
GCGGCCACCACCGGAACATGCGACAGCCGCT	Mycolicibacterium septicum
CCGACTGCTGCGTCGGCATGTTCGACGCGAC	Mycolicibacterium septicum
GCCGTCGACGCCGACCCGGCCAGCGGCAATC	Mycolicibacterium septicum
CCGGGGCGTCGTTGCCGTCGTCGGAACATCG	Mycolicibacterium septicum
TGTGATCTGACCGAACTGGTCGCTGAGCTTG	Mycolicibacterium septicum
TCGGCGGATCCCCCGCCCCCGCCGGACCCGG	Mycolicibacterium septicum
AGGTCAAACTCACCGGGGTGCTGACCACCGG	Mycolicibacterium septicum
CTTGAGCTCACGCGCCTGCAGGATGATCCCG	Mycolicibacterium septicum
GGAACGCCGTACTGGCCGGGCTGACCGTATT	Mycolicibacterium septicum
AACCGTGCGCAGGTCGAAGGAGCTCGTCATG	Mycolicibacterium setense
GAGTGCGGATCTGGTGGTCCGGGACGGCACC	Mycolicibacterium setense
AACCGGCGCCCGTCGAGCAAGAGCGGCATCT	Mycolicibacterium setense
CGGTGAGCGGATCGCCCCAGAAATCCTGAAT	Mycolicibacterium setense
CGTCCGGACTCCACCACGGGCGCCGGCATCA	Mycolicibacterium setense
TGAAGATGCCGGGCTGCTCGGCACCGAAACC	Mycolicibacterium setense
GATGGCCTGGGGCGTGTTCATCGGCCACGAG	Mycolicibacterium setense
CGGAGCCCGAGGCGCTGGCCATCATTCCGGG	Mycolicibacterium setense
CACGCCGGGCGGCGCCCACCGCACGTTCGAC	Mycolicibacterium setense
GGCCGCGATACCGCCGCGGCTCTGGGCCCGC	Mycolicibacterium setense
CGGGTGTGTAACCGTCGGCGCGCACGACGCC	Mycolicibacterium smegmatis
CTGGAACTGCGCGACACCAGCCCCGAGCGCA	Mycolicibacterium smegmatis
TACGCGACGGTGTTCAACGTCCTGTTCGGCA	Mycolicibacterium smegmatis
CTCGCGGTCACCACGCCGGTGCTGGCCGGCC	Mycolicibacterium smegmatis
GTCCCACGGCGGTGGCCCGTCGAGCAGTGGA	Mycolicibacterium smegmatis
CGGCCGGTTCCAGCCGGCCACCCCCACGTTC	Mycolicibacterium smegmatis
CCCGCAGGGCATCTCCCGGCGAGGCATCGCA	Mycolicibacterium smegmatis
TTCCAGCAGGTCGTCGGGCACGGTGTCGTAA	Mycolicibacterium smegmatis
GCGGCTGCAGCACAATGTGATCGGTGTCGCT	Mycolicibacterium smegmatis
GGCGACCTTTTTATCGGTAGCCAGATTTCCA	Mycolicibacterium smegmatis
CTAGCCGTGTGCCTGACGGCCGGAATGGCGG	Mycobacterium szulgai
GCGGGAGCACCGGGCGGTGCGCCACCTGAAG	Mycobacterium szulgai
GAACCACGTCGGGGAGCTCGTTCATGCCGTC	Mycobacterium szulgai
GACGAGGAATACACCGAGCAAAAGAACCGCC	Mycobacterium szulgai
CGTTTGTGCATGATGTCGAAAATGCCACGGG	Mycobacterium szulgai
TTGTTTGATCCCGATCCCGATGCGGTGGGAA	Mycobacterium szulgai
GACGGCTGGGATGCGACCGTCACGCGCGTGC	Mycobacterium szulgai
ACGCGCCGCGACCGCCACCGGGGACGGACGC	Mycobacterium szulgai
CAGGTCACCCGGTTCGGCGCCCTCGATTGCG	Mycobacterium szulgai
TATACGCCCGCTGTGCTGAGCCTATTCCGGC	Mycobacterium szulgai
CTGCTGCTGCGTGACCCCGGGTCCCGCCGGG	Mycolicibacter nonchromogenicus
CCCTGATCGGGGTGTTCGACAAGGTGGGGAT	Mycolicibacter nonchromogenicus
CCGTCCCGGAGGAATTAGCTTGGGCGGCAGT	Mycolicibacter nonchromogenicus
ACCGGATGGTCGGTGCCCCCGGCCAGCACCG	Mycolicibacter nonchromogenicus
ATCCACCAATGCTGACGACTCTGTCGTCGTG	Mycolicibacter nonchromogenicus
TCGAAGCGGTGCGGCGTGCCATCGGCGCCGA	Mycolicibacter nonchromogenicus
ATGTTGGCCAACAGGTTGATGCCCTCCAGGA	Mycolicibacter nonchromogenicus
GGTGCGCGCCAATTCAGCCAGCAGCTCGGCG	Mycolicibacter nonchromogenicus
CAGTCGCGCCGCCTACGCCGAGCTGCTGGCC	Mycolicibacter nonchromogenicus
GATCACGCCGATCAACCAGTCGTGCTGGTCG	Mycolicibacter nonchromogenicus
CAGCTTCCGGCTCGGCCTGCTCGGCCAATAC	Mycolicibacterium sphagni
GTTTTCGGAGCTTCTTCTTGTCGTCGGCGGC	Mycolicibacterium sphagni
CTGGTGAAATCCATGTCAGTCCTATGTCTTT	Mycolicibacterium sphagni
CGGCTGGACCGACAGCGTGCTGCGCCTGGAC	Mycolicibacterium sphagni
TTTTCGGAGCTTCTTCTTGTCGTCGGCGGCC	Mycolicibacterium sphagni
GCACAGCAGCGCCCGGCCCATGGCCTCCATC	Mycolicibacterium sphagni
CGGCCAGCATTGCAGCTCGGTGATCGGCGAG	Mycolicibacterium sphagni
GATTCCGGAGAAGACGTACTTGGCGAACTGT	Mycolicibacterium sphagni
TTCGTGACGACGGTGAAGTCCGGCGCTGACC	Mycolicibacterium sphagni
ACGCATCGGCTACCCGCTCAGCAGTGGATTC	Mycolicibacterium sphagni
GGACGCGGCGCTGGCGGCGTGGTCGCCGAAG	Mycolicibacterium thermoresistibile
CGCCGACACCGCGGCCCTGGCGGCGATCTTG	Mycolicibacterium thermoresistibile
GTGACGACCGCGGTCTTCCCGATCGGGTGGA	Mycolicibacterium thermoresistibile
CCGCCGCCCGTGACTTCGCCGCCGAGGCGGC	Mycolicibacterium thermoresistibile
TCGCCACCCAGGCCGGCAACCGGCTGGATGT	Mycolicibacterium thermoresistibile
GTGGCCGCCCGACGGCCGCGCATCGGCCCCG	Mycolicibacterium thermoresistibile
TGCTGGTCGCCAGCGCCGTGGCCGCGTTCGC	Mycolicibacterium thermoresistibile
AGAAGCCCATGTTGTCCATGGTCTGGTTCAC	Mycolicibacterium thermoresistibile
GCCGTCTGGCACGGAGATCCCGGTGCCGCAC	Mycolicibacterium thermoresistibile
ACGACGCCACCCCGGGCACCGTCATCGACGT	Mycolicibacterium thermoresistibile
CATCAAGCGCCACAATCCAACTACTACGTCG	Mycolicibacterium tokaiense
GAGGTTTCTCCGGCAGCCCTGACCGGTGCCG	Mycolicibacterium tokaiense
CCGGCCCTCCTCTCGATGCACGCCACCTGGT	Mycolicibacterium tokaiense
AGCTTGTGCCCCACCTCGAGTACAGAGGTGT	Mycolicibacterium tokaiense
GGTGCAGACGCACCTGGTGAATGAGGGCGGC	Mycolicibacterium tokaiense
CGACCAACGACAGCACTGTCAGCGCCCGGTC	Mycolicibacterium tokaiense
CAAGCTGCCAGCGTTGGCGTGCGTATCCACC	Mycolicibacterium tokaiense
GCGTTCGTCGGACTCGGGTAGCGACTCATCG	Mycolicibacterium tokaiense
GGAAAATCGGGCCGGTTCTGATGCTCACCGA	Mycolicibacterium tokaiense
ATCAGCAGCTACGACGAGATGCTCAGCTCAC	Mycolicibacterium tokaiense
CGAATCGGGTCCGCGGTAGTCGGGAATCCCG	Mycolicibacterium tusciae
GATGAGCGCTTGCGCGAAGAGCATCGACACG	Mycolicibacterium tusciae
TCGGCTCCGACGCGTCGGTCCATGCCGTCGT	Mycolicibacterium tusciae
GACCTCGACGCGATCCGCGACGCCCTGCGCA	Mycolicibacterium tusciae
AGATCGTCCGCGCCGGCAGGTTTGAAGTCGG	Mycolicibacterium tusciae
CAGCAGCCGCACCAGCCGCGTCGATATCGCG	Mycolicibacterium tusciae
CCCTTACCCGTCCCCATCACCCCGACGACTG	Mycolicibacterium tusciae
CCATCACCCCGACGACTGGGCCGACGTGGAC	Mycolicibacterium tusciae
AATAGTCGTCGATCTTCTTACCGCGCAGCGG	Mycolicibacterium tusciae
TCGATGCCGCTCGACCCGAATGCCATAGGCG	Mycolicibacterium tusciae
GAGCCGTTCGTGGCGCACTTCGGGGGTCCGG	Mycolicibacterium vaccae
GCCGCCCGCGTCCAGGGCGTGGCCTTCCCGC	Mycolicibacterium vaccae
GCGGCTCCCAGAGCCCGAGGTCGGGATCGAA	Mycolicibacterium vaccae
GCATGCAACAGGTCGTCAACGCCCACCTGCA	Mycolicibacterium vaccae
GCCGCCAGATCCGCGCGAAGGAACTCCGTCG	Mycolicibacterium vaccae
ACCGTCATGAACTCCTGCAGGCCTGGTTTAC	Mycolicibacterium vaccae
ACGACGTCGACAAATTCGGTCATGGCGTAAA	Mycolicibacterium vaccae
GCGCACCGGGCCAGGCGGTGCCCATCGCCGG	Mycolicibacterium vaccae
CGGCCCGGCGCTCCACGTTCTACCGGCACAC	Mycolicibacterium vaccae
GATCGCCGCCGCGTTCGCCGTGCTGTTCCTG	Mycolicibacterium vaccae
TCGTCGCCGATGTCCTGGCGCGACATCGTCG	Mycolicibacterium vanbaalenii
CAGGTCGGTGCGCGGTGTGGGCTGGTGCACC	Mycolicibacterium vanbaalenii
GCGCGAGCGTCCACGCCCAGCCCCTCCGCGA	Mycolicibacterium vanbaalenii
CTGGGGCGGGACCGCGCTGCTGCGCCCGGGG	Mycolicibacterium vanbaalenii
CCCACCACGCCGTCCAAATCCTGACGGCCAC	Mycolicibacterium vanbaalenii
GACGGCCCGAGGTTGGTCGAGACGATGCCGC	Mycolicibacterium vanbaalenii
CATCGCCCTGTCATTGCTGGTACCGCGGCGA	Mycolicibacterium vanbaalenii
ACGGGCACGGCATCGGGCATCGCGGCACGAA	Mycolicibacterium vanbaalenii
CGTCATCGCAGCATGTCGAGATTCAGCTGGG	Mycolicibacterium vanbaalenii
GCTGGGGCGGGACCGCGCTGCTGCGCCCGGG	Mycolicibacterium vanbaalenii
TCGGTATGTCGGCGATGTTCCGCAGCTTCAT	Mycolicibacterium wolinskyi
GCGGCAGCGACAACGAATGGGATCAGCACCC	Mycolicibacterium wolinskyi
CCACGGCTGTACCGGATGGCGCGACGACGAC	Mycolicibacterium wolinskyi
CAACGCGCGGGCGAACTGTTGATGACCGAGA	Mycolicibacterium wolinskyi
TCTGGCGGACCTTGGCCGCCTTCTGGTAGGC	Mycolicibacterium wolinskyi
ATCATCGACCGGATTCCCTTCCCGCGCCCCG	Mycolicibacterium wolinskyi
TGGACGGCGCCGACACCCCGATGCTGCACGC	Mycolicibacterium wolinskyi
AGCATTGGTGGGTCAGGCAAGTGTCGACGAC	Mycolicibacterium wolinskyi
ACGCGTTCGGCTGGCTGGCGGGCATGTCGAA	Mycolicibacterium wolinskyi
TGCTGTCCGCGGCGGACGTCGGCCGGACAAT	Mycolicibacterium wolinskyi
GCGTACTTCACGACGGTGTTCGTCGCCGCCC	Mycolicibacter kumamotonensis
CCGCGGTGGCGAGTGTCCCGTGCACCGGGCG	Mycolicibacter kumamotonensis
AGGCGAAGGGCCCCGACTTGGCGATCCACAC	Mycolicibacter kumamotonensis
GACGAAGCGCGATCGCCACGTGCCGGTGCCG	Mycolicibacter kumamotonensis
GATCCAGGCTCCCGGCGCCGAGCAGAGCGCT	Mycolicibacter kumamotonensis
CCGTCTGTCACGCGCTGCGGTCGGTCTTCGA	Mycolicibacter kumamotonensis
GTCCGGGCACCCCGAACACCGCACCGGCCGC	Mycolicibacter kumamotonensis
CAGCCAGCCCGGAGAAGTTGATCTACACCGA	Mycolicibacter kumamotonensis
CGAGTTCGATCGCCGGATGCGCCGACACCTG	Mycolicibacter kumamotonensis
AGGACCCGGGTCACCTTCTCGCTGTCGCGGC	Mycolicibacter kumamotonensis
TCAACCGCACCGAGCCCGACACCTGCGCGTG	Mycolicibacter minnesotensis
TGGCTGACCAGGGCATGGATGCTGTCCTGTT	Mycolicibacter minnesotensis
CCCACCGTCGACTGCCCAACCCCGCTCGGCC	Mycolicibacter minnesotensis
CGGGCGCGGACAGCCTCGCGCACGCACACGA	Mycolicibacter minnesotensis
TCAGTCAGGCCCTGTCGGCGTTACGCCTGGC	Mycolicibacter minnesotensis
CGTCGCCGCGCCGGCCGGTGGTGGCTGTCGC	Mycolicibacter minnesotensis
GCTCTTGGTGCTGACGGTAACCGGAATGCTC	Mycolicibacter minnesotensis
TGGTGCAGGTTGAGCGCCTCGGTGTTCCAGC	Mycolicibacter minnesotensis
CGTGGCCCCTGGCGACAGCGATGTCAGGGCT	Mycolicibacter minnesotensis
GAACGGAATGCGCAGGTCGGCGGGCACGATG	Mycolicibacter minnesotensis
GGAGGAACTGGCGCTGCTGCACCTCACCGAC	Mycolicibacter senuensis
TGATCCAGACCGCGGTGGTGATGCCGGTGGT	Mycolicibacter senuensis
GGGCCCTCATAGGCGCCGACCACTTCCTCGA	Mycolicibacter senuensis
CGTCGGGCGGGGCGCGCATTCTCACTGGCTC	Mycolicibacter senuensis
CGCGGGACCGCACACCGACCGGACCCTGGAC	Mycolicibacter senuensis
GCGACTGCTGGCCGATGCGGTGGTGCGTTCG	Mycolicibacter senuensis
CCGACGAACGGCAGCGCGGTCTGGGTGTTCG	Mycolicibacter senuensis
CTCGGCATCGCCGACATCGTGACGGTCTCCA	Mycolicibacter senuensis
GCCGGGCAAGCCGGTCGACGAACACCTGAAC	Mycolicibacter senuensis
CGACCGCATTCCGGGGATCGCTGGCCACGTC	Mycolicibacter senuensis
GCGCCGATCTGGACCGGATGGACCACCAGCG	Mycolicibacter sinensis
CGCGCCGATCTGGACCGGATGGACCACCAGC	Mycolicibacter sinensis
TGCGCACCGAGATCGTCAACACGCTGGCGAA	Mycolicibacter terrae
CGCGGACGTGAGAACGGCGGTGGTGCGCGTC	Mycolicibacter terrae
CGATGAACAGGCCCAGCCAGGCCCCGGTCAG	Mycolicibacter terrae
AGTCGCTCGCCGCCCGCGGGGAGCGGGCGGT	Mycolicibacter terrae
CGGCCCGCGCCGGCCGCCGGACACCAGGCCG	Mycolicibacter terrae
ACGGCCCAGACGTGGCCGTGGGTGTCCTGGC	Mycolicibacter terrae
CGCCCGGCAGTACGAACAGGTGATGCTGCTT	Mycolicibacter terrae
ATCACTTTGAATCCGCCGCGGATGATGGCCT	Mycolicibacter terrae
ACCGATGTTGCGGGACAAGGCGTTTGCGCAA	Mycolicibacter terrae
CCAGGTCGGGCCGGACCACTGGTGGGACGGC	Mycolicibacter terrae
